year,Continent,cropland_ba_hectares,forest_ba_hectares,grass_and_shrubland_ba_hectares,wetlands_ba_hectares,settlement_ba_hectares,other_ba_hectares,total_ba_hectares
2002,Africa,34878806,136023543,104306217,6199087,22755,159727,281590135
2002,Asia,13488418,4791327,19851899,158961,16915,362362,38669882
2002,Europe,8599004,7345205,2521946,317092,17338,57919,18858504
2002,North America,1449022,4007263,1498897,290299,2754,52450,7300685
2002,Oceania,561488,6595404,69755413,341383,3106,131754,77388548
2002,South America,8743974,9300939,18459072,3680012,15514,9431,40208942
2003,Africa,39343334,163475595,96042552,6354408,22114,194308,305432311
2003,Asia,13276186,7361642,9312853,215137,25918,390473,30582209
2003,Europe,5069724,14178935,4217972,621824,20349,74982,24183786
2003,North America,2633038,4673170,1989016,193941,6716,48491,9544372
2003,Oceania,517287,5870538,25493867,160947,1564,14787,32058990
2003,South America,8432935,7946289,16552272,3517589,17754,12481,36479320
2004,Africa,41792779,150608727,95681995,6029895,23643,304056,294441095
2004,Asia,15379174,10991905,13121535,192805,27468,903133,40616020
2004,Europe,6916103,3680105,1773443,239418,20914,33235,12663218
2004,North America,1994812,4045444,2090260,178231,4723,38448,8351918
2004,Oceania,1581411,5965226,56873171,251401,1173,45569,64717951
2004,South America,9774229,9336799,17834350,3616190,17959,15144,40594671
2005,Africa,43662786,172204258,104805577,7185285,27573,566676,328452155
2005,Asia,14563093,5912191,12039822,234446,38786,476927,33265265
2005,Europe,9987405,3368620,2809777,554156,54189,63993,16838140
2005,North America,2375857,4625129,3188642,233300,5303,32864,10461095
2005,Oceania,856270,3709269,23422950,199840,1305,12234,28201868
2005,South America,9222330,10048300,17165712,4147733,17102,17775,40618952
2006,Africa,38003178,149074621,90407878,6202193,30003,179708,283897581
2006,Asia,15773408,6780324,12947663,208137,54873,293479,36057884
2006,Europe,8903466,4717213,3283292,259712,37773,83935,17285391
2006,North America,1895072,3425522,2642654,202163,3456,35892,8204759
2006,Oceania,1157755,6399567,50356170,191039,1262,30930,58136723
2006,South America,6883567,6620754,11565343,3106913,11699,7734,28196010
2007,Africa,40626722,151194361,102459996,5856376,25186,469562,300632203
2007,Asia,14474583,9427425,8849040,189352,69585,363328,33373313
2007,Europe,8536362,3343867,2614690,217289,45692,48597,14806497
2007,North America,2267179,3414338,2297792,204348,6093,58044,8247794
2007,Oceania,254261,4289836,46986096,211284,1820,40051,51783348
2007,South America,11859442,14160105,26314189,3690448,19652,8660,56052496
2008,Africa,36611499,156481734,98520840,5650344,28214,215124,297507755
2008,Asia,11890064,6607789,7819551,288437,35521,203030,26844392
2008,Europe,15332353,9490542,4000818,487313,49845,68775,29429646
2008,North America,1958595,3112207,1849576,210664,7774,20366,7159182
2008,Oceania,345384,3832783,27573700,119665,1004,11483,31884019
2008,South America,7257745,6218743,13827315,4005030,13770,10250,31332853
2009,Africa,32551785,140672463,88878118,6020163,23216,197579,268343324
2009,Asia,13766574,9860092,5247520,275185,52247,123350,29324968
2009,Europe,9249619,4331776,1970897,330070,56164,80287,16018813
2009,North America,1913432,2705066,1906361,102245,3393,37874,6668371
2009,Oceania,561587,5936938,34402507,214797,1499,11138,41128466
2009,South America,5224310,3925465,9552966,2290250,12447,10245,21015683
2010,Africa,33016088,149369799,98431962,6001712,24692,371365,287215618
2010,Asia,16130850,9061701,10830829,173716,52698,149214,36399008
2010,Europe,5704913,4686245,2218515,227063,43007,110387,12990130
2010,North America,1951146,3173188,1549507,242902,3544,29623,6949910
2010,Oceania,619372,2351209,15661280,119003,1068,9914,18761846
2010,South America,11048877,15149161,24796169,3926402,18385,10117,54949111
2011,Africa,31779761,151546463,107577463,5670856,31557,427840,297033940
2011,Asia,12235261,6066456,4070499,120142,60933,202799,22756090
2011,Europe,4899337,6728974,2879157,355236,54853,48498,14966055
2011,North America,2014022,4825402,3334260,232629,6181,14791,10427285
2011,Oceania,1269662,5722044,79350698,144753,1519,2040847,88529523
2011,South America,6501648,5305234,11975789,2445293,9873,11148,26248985
2012,Africa,30576655,141504285,96057344,5800008,25488,362655,274326435
2012,Asia,16535844,8689572,5683163,235349,82758,75977,31302663
2012,Europe,4041944,9431172,2484089,800049,47062,63306,16867622
2012,North America,1381816,3595248,2205530,153379,2709,41069,7379751
2012,Oceania,937543,7210309,81638186,321655,1004,296892,90405589
2012,South America,6242523,7772796,17940420,3133703,12965,11191,35113598
2013,Africa,30122840,143293113,87749802,5454902,27639,178938,266827234
2013,Asia,12061632,6228952,2951745,240990,68945,139238,21691502
2013,Europe,2326931,4715453,857856,223008,34353,38112,8195713
2013,North America,1667868,5495978,1402202,395440,4142,46820,9012450
2013,Oceania,533590,4048151,23661011,233092,2249,252239,28730332
2013,South America,4852131,4056680,10633246,1980425,9613,17503,21549598
2014,Africa,25528116,137441167,80271442,4829643,29808,303205,248403381
2014,Asia,15686915,7772025,7039217,207223,89378,146825,30941583
2014,Europe,8133448,7960284,3448973,281210,76010,28407,19928332
2014,North America,1276834,3844648,1748434,305068,4099,38823,7217906
2014,Oceania,971715,4614394,41610118,242148,1649,26227,47466251
2014,South America,5310700,4524329,14661804,1835145,10594,9840,26352412
2015,Africa,27594058,139886165,84201790,5993757,32817,212131,257920718
2015,Asia,16193457,8216539,8702270,408891,98427,178682,33798266
2015,Europe,5873644,4450925,2199210,154400,42608,69904,12790691
2015,North America,1917707,5281048,1568565,196992,4914,29800,8999026
2015,Oceania,928129,4659329,37321277,284120,2933,24467,43220255
2015,South America,5869505,7580488,14904929,2242446,13596,9472,30620436
2016,Africa,31496371,150451559,83308600,6157716,29483,275912,271719641
2016,Asia,11012287,6432711,3965911,270694,61072,182137,21924812
2016,Europe,3510024,5825878,1876099,270879,20149,95441,11598470
2016,North America,1735403,2850963,1791709,111737,4229,25993,6520034
2016,Oceania,591894,3147184,19007011,186403,1563,9142,22943197
2016,South America,5714875,7254331,14172324,2695705,13713,13011,29863959
2017,Africa,25801222,138657447,77042281,5609658,21087,175488,247307183
2017,Asia,14097482,6825785,12691269,145432,92403,187647,34040018
2017,Europe,5363488,4805506,1579661,169773,29863,19555,11967846
2017,North America,1687317,5151102,2557276,252653,7104,24710,9680162
2017,Oceania,1549279,3542889,44225541,166136,1345,45054,49530244
2017,South America,6407830,9976961,17242942,2818252,15123,11992,36473100
2018,Africa,23464342,130055452,79972571,5388531,22895,269163,239172954
2018,Asia,10118300,6671993,3398516,145212,55939,131570,20521530
2018,Europe,3779825,7625187,1772370,354954,122113,32443,13686892
2018,North America,1373123,4092509,2151854,137997,6196,26018,7787697
2018,Oceania,670805,4817577,47148613,228327,1412,19403,52886137
2018,South America,4456523,4882291,10498052,1734220,10076,11344,21592506
2019,Africa,23026383,126786632,65544431,6067485,22618,285302,221732851
2019,Asia,15019153,6864191,7572783,450675,54186,1478668,31439656
2019,Europe,4966550,6661495,2382650,415745,36679,60822,14523941
2019,North America,1739348,3684963,1592657,114094,5409,16855,7153326
2019,Oceania,817673,8639235,26825766,269991,1994,21461,36576120
2019,South America,6278895,10398585,15491938,3326274,13539,8529,35517760
