year,gid_0,country,cropland_ba_hectares,forest_ba_hectares,grass_and_shrubland_ba_hectares,wetlands_ba_hectares,settlement_ba_hectares,other_ba_hectares,total_ba_hectares
2002,AFG,Afghanistan,258,0,14746,0,0,17237,32241
2002,AGO,Angola,1077481,19467009,14478768,93907,1822,1563,35120550
2002,ALA,Åland,0,0,0,0,0,0,0
2002,ALB,Albania,0,0,0,0,0,0,0
2002,AND,Andorra,0,0,0,0,0,0,0
2002,ARE,United Arab Emirates,0,0,0,0,21,0,21
2002,ARG,Argentina,1293138,727661,2754617,350398,2228,4910,5132952
2002,ARM,Armenia,5881,235,85,0,0,21,6222
2002,ASM,American Samoa,0,0,0,0,0,0,0
2002,ATF,French Southern Territories,0,0,0,0,0,0,0
2002,ATG,Antigua and Barbuda,0,0,0,0,0,0,0
2002,AUS,Australia,319267,6536377,69701646,330849,1412,131733,77021284
2002,AUT,Austria,1138,64,0,0,0,0,1202
2002,AZE,Azerbaijan,194479,3538,13391,64,85,191,211748
2002,BDI,Burundi,21120,17385,44776,299,0,0,83580
2002,BEL,Belgium,0,0,0,0,0,0,0
2002,BEN,Benin,367296,1307951,1194207,86,407,0,2869947
2002,BES,"Bonaire, Sint Eustatius and Saba",0,0,0,0,0,0,0
2002,BFA,Burkina Faso,2110653,326708,1432370,6585,0,0,3876316
2002,BGD,Bangladesh,3477,1052,773,579,0,0,5881
2002,BGR,Bulgaria,28676,1135,85,0,21,0,29917
2002,BHR,Bahrain,0,0,0,0,0,0,0
2002,BHS,Bahamas,386,16098,214,428,21,0,17147
2002,BIH,Bosnia and Herzegovina,1094,729,386,0,0,0,2209
2002,BLR,Belarus,89253,64910,25412,4141,21,0,183737
2002,BLZ,Belize,2037,20649,2768,556,0,0,26010
2002,BMU,Bermuda,0,0,0,0,0,0,0
2002,BOL,Bolivia,822182,1945670,1149107,717601,771,257,4635588
2002,BRA,Brazil,5504183,5004696,10859450,1798933,11150,3323,23181735
2002,BRB,Barbados,0,0,0,0,0,0,0
2002,BRN,Brunei,0,0,0,0,0,0,0
2002,BTN,Bhutan,428,2103,107,0,0,0,2638
2002,BWA,Botswana,215085,260208,7473534,218973,21,2488,8170309
2002,CAF,Central African Republic,398509,13340172,3377155,8240,171,0,17124247
2002,CAN,Canada,67165,1768960,403686,223089,43,23460,2486403
2002,CHE,Switzerland,0,258,0,0,0,0,258
2002,CHL,Chile,4397,27045,16353,234,0,643,48672
2002,CHN,China,1108929,216955,192929,68060,7682,6049,1600604
2002,CIV,Côte d'Ivoire,424078,3119033,666364,1521,189,0,4211185
2002,CMR,Cameroon,404393,3929754,691540,69077,63,215,5095042
2002,COD,Democratic Republic of the Congo,2721689,23610022,3419484,1450413,3364,686,31205658
2002,COG,Republic of Congo,177370,996869,524752,8584,0,0,1707575
2002,COL,Colombia,75639,98521,1735127,94981,318,0,2004586
2002,COM,Comoros,0,0,0,0,0,0,0
2002,CPV,Cape Verde,0,0,0,0,0,0,0
2002,CRI,Costa Rica,19704,7257,879,235,0,0,28075
2002,CUB,Cuba,82364,33973,17169,2184,42,0,135732
2002,CYM,Cayman Islands,0,0,0,0,0,0,0
2002,CYP,Cyprus,1117,0,364,0,0,64,1545
2002,CZE,Czech Republic,257,86,0,0,0,0,343
2002,DEU,Germany,945,0,0,0,0,0,945
2002,DJI,Djibouti,0,0,0,0,0,0,0
2002,DMA,Dominica,0,0,0,0,0,0,0
2002,DNK,Denmark,2384,0,0,0,0,0,2384
2002,DOM,Dominican Republic,2231,514,493,128,43,0,3409
2002,DZA,Algeria,7810,22707,4914,365,0,8006,43802
2002,ECU,Ecuador,557,1927,3216,386,0,0,6086
2002,EGY,Egypt,11700,0,0,128,85,0,11913
2002,ERI,Eritrea,35934,386,9811,107,107,21,46366
2002,ESH,Western Sahara,0,0,0,0,0,0,0
2002,ESP,Spain,116128,26982,13866,599,63,385,158023
2002,EST,Estonia,578,1304,63,2661,129,0,4735
2002,ETH,Ethiopia,685747,4506758,3189908,49473,299,9229,8441414
2002,FIN,Finland,171,192,0,0,107,21,491
2002,FJI,Fiji,0,0,0,0,0,0,0
2002,FRA,France,86206,3992,2211,193,321,21,92944
2002,FRO,Faroe Islands,0,0,0,0,0,0,0
2002,FSM,Micronesia,0,0,0,0,0,0,0
2002,GAB,Gabon,7191,100074,99560,64,0,0,206889
2002,GBR,United Kingdom,0,0,0,0,0,0,0
2002,GEO,Georgia,2083,515,0,0,0,0,2598
2002,GGY,Guernsey,0,0,0,0,0,0,0
2002,GHA,Ghana,1329680,3302716,1831533,23266,191,149,6487535
2002,GIN,Guinea,488172,3905800,586941,14659,748,0,4996320
2002,GLP,Guadeloupe,0,0,0,0,0,0,0
2002,GMB,Gambia,208603,41557,31384,7059,43,150,288796
2002,GNB,Guinea-Bissau,50852,668658,14080,15022,0,128,748740
2002,GNQ,Equatorial Guinea,0,0,0,0,0,0,0
2002,GRC,Greece,21080,279,1395,64,21,170,23009
2002,GRD,Grenada,0,0,0,0,0,0,0
2002,GRL,Greenland,0,0,0,0,0,0,0
2002,GTM,Guatemala,231765,81353,15280,1307,85,21,329811
2002,GUF,French Guiana,235,859,171,944,322,0,2531
2002,GUM,Guam,0,0,0,0,0,0,0
2002,GUY,Guyana,14359,15219,24063,1349,407,0,55397
2002,HKG,Hong Kong,0,0,0,21,0,0,21
2002,HND,Honduras,30285,63446,15537,1157,43,0,110468
2002,HRV,Croatia,4613,1374,300,0,0,0,6287
2002,HTI,Haiti,0,0,1867,64,0,0,1931
2002,HUN,Hungary,15710,170,2961,1051,21,0,19913
2002,IDN,Indonesia,1767711,640621,265826,28004,4416,0,2706578
2002,IMN,Isle of Man,0,0,0,0,0,0,0
2002,IND,India,1798318,266797,21694,3345,2188,63,2092405
2002,IRL,Ireland,0,0,0,0,0,0,0
2002,IRN,Iran,255370,362,15662,2229,642,62032,336297
2002,IRQ,Iraq,89253,1674,3900,2980,0,34921,132728
2002,ISL,Iceland,0,0,0,0,0,0,0
2002,ISR,Israel,4487,751,601,0,0,364,6203
2002,ITA,Italy,67659,4635,2061,558,343,856,76112
2002,JAM,Jamaica,708,85,0,0,0,0,793
2002,JEY,Jersey,0,0,0,0,0,0,0
2002,JOR,Jordan,150,0,0,0,0,172,322
2002,JPN,Japan,5431,5216,1868,43,0,0,12558
2002,KAZ,Kazakhstan,5157195,23027,18075053,26784,662,179513,23462234
2002,KEN,Kenya,134820,30711,78798,4565,21,794,249709
2002,KGZ,Kyrgyzstan,19489,878,30738,0,0,107,51212
2002,KHM,Cambodia,508632,2039570,65338,10453,0,0,2623993
2002,KNA,Saint Kitts and Nevis,0,0,0,0,0,0,0
2002,KOR,South Korea,3068,2275,21,0,0,0,5364
2002,KWT,Kuwait,0,0,0,43,0,494,537
2002,LAO,Laos,83562,166421,107262,877,0,0,358122
2002,LBN,Lebanon,0,0,0,0,0,0,0
2002,LBR,Liberia,730,301,0,0,21,0,1052
2002,LBY,Libya,150,258,429,21,0,214,1072
2002,LCA,Saint Lucia,0,0,0,0,0,0,0
2002,LIE,Liechtenstein,0,0,0,0,0,0,0
2002,LKA,Sri Lanka,57056,1478,6503,1179,0,0,66216
2002,LSO,Lesotho,1737,2465,40654,21,21,86,44984
2002,LTU,Lithuania,5365,514,341,129,0,0,6349
2002,LUX,Luxembourg,0,0,0,0,0,0,0
2002,LVA,Latvia,3711,1738,1544,729,0,0,7722
2002,MAC,Macao,0,0,0,0,0,0,0
2002,MAR,Morocco,236,193,64,21,0,21,535
2002,MDA,Moldova,14446,85,85,64,0,0,14680
2002,MDG,Madagascar,75151,967896,2427939,18304,320,9272,3498882
2002,MEX,Mexico,485062,880926,165665,9199,1713,2187,1544752
2002,MKD,Macedonia,3776,129,21,21,0,21,3968
2002,MLI,Mali,3032504,769401,3080307,16572,64,6010,6904858
2002,MLT,Malta,0,0,0,0,0,0,0
2002,MMR,Myanmar,398877,767919,206265,3494,86,0,1376641
2002,MNE,Montenegro,0,0,0,0,0,0,0
2002,MNG,Mongolia,200317,201863,613538,2230,0,1350,1019298
2002,MNP,Northern Mariana Islands,0,0,0,0,0,0,0
2002,MOZ,Mozambique,1957557,10932991,5765191,577513,233,97255,19330740
2002,MRT,Mauritania,47457,64,42458,3648,0,0,93627
2002,MSR,Montserrat,0,0,0,0,0,0,0
2002,MTQ,Martinique,0,0,0,0,0,0,0
2002,MUS,Mauritius,451,0,0,0,0,0,451
2002,MWI,Malawi,214435,201642,102558,10252,42,128,529057
2002,MYS,Malaysia,27538,8477,107,599,0,0,36721
2002,MYT,Mayotte,0,0,0,0,0,0,0
2002,NAM,Namibia,159362,607008,2337509,46064,85,4035,3154063
2002,NCL,New Caledonia,6696,1610,3970,149,43,0,12468
2002,NER,Niger,77789,106,184497,1975,0,170,264537
2002,NGA,Nigeria,4232163,2756146,2529727,84032,5339,448,9607855
2002,NIC,Nicaragua,35694,27300,20241,5170,149,0,88554
2002,NLD,Netherlands,0,0,0,0,0,0,0
2002,NOR,Norway,429,21,0,43,0,0,493
2002,NPL,Nepal,3800,19167,1909,21,0,0,24897
2002,NRU,Nauru,0,0,0,0,0,0,0
2002,NZL,New Zealand,0,21,21,0,21,21,84
2002,OMN,Oman,0,0,0,0,0,64,64
2002,PAK,Pakistan,111558,6547,1845,751,0,0,120701
2002,PAN,Panama,22474,8005,1029,128,21,85,31742
2002,PER,Peru,8586,24510,6200,321,85,277,39979
2002,PHL,Philippines,111764,12228,10923,511,171,0,135597
2002,PLW,Palau,0,0,0,0,0,0,0
2002,PNG,Papua New Guinea,235525,57310,49776,10342,1630,0,354583
2002,POL,Poland,16290,426,149,1072,21,0,17958
2002,PRI,Puerto Rico,0,0,150,0,0,0,150
2002,PRK,North Korea,4355,13244,644,214,215,0,18672
2002,PRT,Portugal,33931,62978,4914,148,64,84,102119
2002,PRY,Paraguay,822541,1317144,645003,465696,84,21,3250489
2002,PSE,Palestina,236,0,214,0,0,42,492
2002,PYF,French Polynesia,0,0,0,0,0,0,0
2002,QAT,Qatar,0,0,43,0,0,21,64
2002,REU,Reunion,0,0,0,0,0,0,0
2002,ROU,Romania,30563,1994,792,8176,191,0,41716
2002,RUS,Russia,5925776,7122299,2430452,291955,4968,56340,15831790
2002,RWA,Rwanda,10432,8477,41944,580,0,0,61433
2002,SAU,Saudi Arabia,64910,0,1029,21,64,43423,109447
2002,SDN,Sudan,2226761,1425182,4565399,64545,706,1391,8283984
2002,SEN,Senegal,835361,2107748,2004418,9376,21,85,4957009
2002,SGP,Singapore,0,0,0,0,0,0,0
2002,SHN,Saint Helena,0,0,0,0,0,0,0
2002,SJM,Svalbard and Jan Mayen,0,0,0,0,0,0,0
2002,SLB,Solomon Islands,0,86,0,43,0,0,129
2002,SLE,Sierra Leone,187245,340727,18610,1028,578,0,548188
2002,SLV,El Salvador,3348,793,0,64,0,0,4205
2002,SMR,San Marino,0,0,0,0,0,0,0
2002,SOM,Somalia,18116,257,4015,0,301,0,22689
2002,SPM,Saint Pierre and Miquelon,0,0,0,0,0,0,0
2002,SRB,Serbia,16054,1739,899,85,0,0,18777
2002,SSD,South Sudan,822764,12737024,20544034,1235719,597,0,35340138
2002,STP,São Tomé and Príncipe,0,0,0,0,0,0,0
2002,SUR,Suriname,1867,9787,32692,449,43,0,44838
2002,SVK,Slovakia,5818,21,0,0,129,0,5968
2002,SVN,Slovenia,0,0,0,0,0,0,0
2002,SWE,Sweden,171,0,0,0,0,0,171
2002,SWZ,Swaziland,21721,24833,33873,128,129,1179,81863
2002,SYC,Seychelles,0,0,0,0,0,0,0
2002,SYR,Syria,31468,64,106,343,0,1030,33011
2002,TCA,Turks and Caicos Islands,0,0,0,0,0,0,0
2002,TCD,Chad,3024024,1632348,6960203,120847,1607,1995,11741024
2002,TGO,Togo,450524,492834,229939,235,86,0,1173618
2002,THA,Thailand,805540,218809,86279,3294,63,0,1113985
2002,TJK,Tajikistan,5944,0,879,0,0,21,6844
2002,TKL,Tokelau,0,0,0,0,0,0,0
2002,TKM,Turkmenistan,33574,21,57117,384,0,10923,102019
2002,TLS,Timor-Leste,21441,2315,107,43,21,0,23927
2002,TON,Tonga,0,0,0,0,0,0,0
2002,TTO,Trinidad and Tobago,0,0,0,0,0,0,0
2002,TUN,Tunisia,493,943,0,258,0,494,2188
2002,TUR,Turkey,380623,3839,6841,790,450,1880,394423
2002,TUV,Tuvalu,0,0,0,0,0,0,0
2002,TWN,Taiwan,86,0,0,0,0,0,86
2002,TZA,Tanzania,1259267,6642562,3622175,1224301,512,4829,12753646
2002,UGA,Uganda,815759,1052101,848903,6515,21,0,2723299
2002,UKR,Ukraine,2106782,47151,34009,5403,10918,21,2204284
2002,UMI,United States Minor Outlying Islands,0,0,0,0,0,0,0
2002,URY,Uruguay,13645,4692,10873,899,0,0,30109
2002,USA,United States,465799,1097904,853919,46590,594,26697,2491503
2002,UZB,Uzbekistan,10430,964,16310,728,21,2359,30812
2002,VCT,Saint Vincent and the Grenadines,0,0,0,0,0,0,0
2002,VEN,Venezuela,182645,123208,1222200,247821,106,0,1775980
2002,VGB,British Virgin Islands,0,0,0,0,0,0,0
2002,VIR,"Virgin Islands, U.S.",0,0,0,0,0,0,0
2002,VNM,Vietnam,209583,162402,30861,856,128,0,403830
2002,VUT,Vanuatu,0,0,0,0,0,0,0
2002,WLF,Wallis and Futuna,0,0,0,0,0,0,0
2002,WSM,Samoa,0,0,0,0,0,0,0
2002,XAD,Akrotiri and Dhekelia,0,0,0,0,0,0,0
2002,XKO,Kosovo,0,0,0,0,0,0,0
2002,XNC,Northern Cyprus,0,0,21,0,0,0,21
2002,YEM,Yemen,0,0,0,21,0,21,42
2002,ZAF,South Africa,637922,374514,4260476,22554,2978,8302,5306746
2002,ZMB,Zambia,3398412,13220570,4432613,774421,1414,21,21827451
2002,ZWE,Zimbabwe,492100,770474,1078403,7764,149,363,2349253
2003,AFG,Afghanistan,7768,0,44154,1395,0,83675,136992
2003,AGO,Angola,1260153,22744950,16989092,117973,2202,2016,41116386
2003,ALA,Åland,0,0,0,0,0,0,0
2003,ALB,Albania,11394,2230,1373,107,0,279,15383
2003,AND,Andorra,0,0,0,0,0,0,0
2003,ARE,United Arab Emirates,0,0,0,0,43,21,64
2003,ARG,Argentina,1661447,1135171,3085118,804403,1516,5043,6692698
2003,ARM,Armenia,2489,64,42,0,0,0,2595
2003,ASM,American Samoa,0,0,0,0,0,0,0
2003,ATF,French Southern Territories,0,0,0,0,0,0,0
2003,ATG,Antigua and Barbuda,0,0,0,0,0,0,0
2003,AUS,Australia,294921,5813813,25414405,158029,599,14680,31696447
2003,AUT,Austria,1782,191,0,0,0,21,1994
2003,AZE,Azerbaijan,179579,7125,24535,43,21,749,212052
2003,BDI,Burundi,24555,15344,41837,2402,42,0,84180
2003,BEL,Belgium,0,21,0,0,0,0,21
2003,BEN,Benin,547188,955785,1078037,385,234,42,2581671
2003,BES,"Bonaire, Sint Eustatius and Saba",0,0,0,0,0,0,0
2003,BFA,Burkina Faso,1893007,258534,1328586,4378,0,0,3484505
2003,BGD,Bangladesh,3669,16100,11656,279,0,0,31704
2003,BGR,Bulgaria,51816,772,236,342,301,129,53596
2003,BHR,Bahrain,0,0,0,0,0,0,0
2003,BHS,Bahamas,86,1546,0,537,0,0,2169
2003,BIH,Bosnia and Herzegovina,10239,17904,46688,322,43,21,75217
2003,BLR,Belarus,33956,33741,3154,386,21,0,71258
2003,BLZ,Belize,9830,64161,9294,2124,0,0,85409
2003,BMU,Bermuda,0,0,0,0,0,0,0
2003,BOL,Bolivia,505925,1034034,866812,426242,448,170,2833631
2003,BRA,Brazil,4504771,3650438,7586633,690907,12156,3214,16448119
2003,BRB,Barbados,0,0,0,0,0,0,0
2003,BRN,Brunei,170,386,0,21,0,0,577
2003,BTN,Bhutan,42,707,558,0,0,0,1307
2003,BWA,Botswana,79164,73692,1136294,108896,0,21,1398067
2003,CAF,Central African Republic,441054,22320357,4048180,12186,276,42,26822095
2003,CAN,Canada,78714,1340371,365240,84122,107,10664,1879218
2003,CHE,Switzerland,0,107,193,0,0,21,321
2003,CHL,Chile,24531,10814,43162,42,64,257,78870
2003,CHN,China,1628797,1160461,528615,107600,11757,9809,3447039
2003,CIV,Côte d'Ivoire,429744,2863968,534777,1886,491,0,3830866
2003,CMR,Cameroon,560383,5458770,962056,58470,235,21,7039935
2003,COD,Democratic Republic of the Congo,3204890,26628233,3537157,1722968,3120,149,35096517
2003,COG,Republic of Congo,395377,1774086,980688,14464,43,0,3164658
2003,COL,Colombia,177622,235087,2438347,303649,488,0,3155193
2003,COM,Comoros,515,666,21,0,0,0,1202
2003,CPV,Cape Verde,0,0,0,0,0,0,0
2003,CRI,Costa Rica,22901,16014,815,321,21,0,40072
2003,CUB,Cuba,119646,18198,21952,1563,64,0,161423
2003,CYM,Cayman Islands,0,0,0,0,0,0,0
2003,CYP,Cyprus,987,21,1159,0,0,278,2445
2003,CZE,Czech Republic,1716,964,923,0,301,0,3904
2003,DEU,Germany,708,1330,214,0,107,0,2359
2003,DJI,Djibouti,0,0,0,0,0,0,0
2003,DMA,Dominica,0,0,0,0,0,0,0
2003,DNK,Denmark,11698,236,215,0,21,0,12170
2003,DOM,Dominican Republic,14980,5384,1738,1157,21,0,23280
2003,DZA,Algeria,25478,25197,39472,107,21,1932,92207
2003,ECU,Ecuador,6503,5815,5710,578,0,0,18606
2003,EGY,Egypt,6503,0,0,0,150,0,6653
2003,ERI,Eritrea,17818,85,11592,64,150,129,29838
2003,ESH,Western Sahara,0,0,0,0,0,0,0
2003,ESP,Spain,118594,64289,22793,535,84,814,207109
2003,EST,Estonia,1867,2618,258,0,0,0,4743
2003,ETH,Ethiopia,609072,3721106,2075661,33096,84,11611,6450630
2003,FIN,Finland,4743,1202,0,107,0,0,6052
2003,FJI,Fiji,9618,2190,193,279,0,0,12280
2003,FRA,France,19488,28783,23762,128,343,1031,73535
2003,FRO,Faroe Islands,0,0,0,0,0,0,0
2003,FSM,Micronesia,0,0,0,0,0,0,0
2003,GAB,Gabon,10047,118575,155885,63,0,0,284570
2003,GBR,United Kingdom,1007,728,13009,8007,0,0,22751
2003,GEO,Georgia,4956,836,986,0,0,987,7765
2003,GGY,Guernsey,0,0,0,0,0,0,0
2003,GHA,Ghana,1338976,3846214,1948070,29127,470,255,7163112
2003,GIN,Guinea,486797,3172934,523400,23955,362,21,4207469
2003,GLP,Guadeloupe,0,0,0,0,0,0,0
2003,GMB,Gambia,111086,22691,22280,11932,0,212,168201
2003,GNB,Guinea-Bissau,75686,612164,11700,22622,21,106,722299
2003,GNQ,Equatorial Guinea,0,0,0,0,0,0,0
2003,GRC,Greece,10428,0,1223,0,0,86,11737
2003,GRD,Grenada,0,0,0,0,0,0,0
2003,GRL,Greenland,0,0,0,0,0,0,0
2003,GTM,Guatemala,434199,371466,44217,2702,192,21,852797
2003,GUF,French Guiana,300,1266,451,901,364,0,3282
2003,GUM,Guam,0,0,0,0,0,0,0
2003,GUY,Guyana,26164,96528,31938,9913,1589,0,166132
2003,HKG,Hong Kong,708,192,214,0,0,0,1114
2003,HND,Honduras,140941,425684,133580,4162,234,21,704622
2003,HRV,Croatia,12704,3520,5559,299,21,235,22338
2003,HTI,Haiti,106,0,407,86,0,0,599
2003,HUN,Hungary,32389,215,1222,278,128,0,34232
2003,IDN,Indonesia,502339,137628,91889,6712,3580,0,742148
2003,IMN,Isle of Man,0,0,0,0,0,0,0
2003,IND,India,1943624,821497,63915,8985,3239,84,2841344
2003,IRL,Ireland,0,170,107,814,0,0,1091
2003,IRN,Iran,216219,64,15336,1415,299,36507,269840
2003,IRQ,Iraq,82149,21,5513,598,3412,32732,124425
2003,ISL,Iceland,0,0,0,0,0,0,0
2003,ISR,Israel,1697,320,1138,0,0,107,3262
2003,ITA,Italy,136521,3690,14251,212,235,362,155271
2003,JAM,Jamaica,1159,301,128,0,0,0,1588
2003,JEY,Jersey,0,0,0,0,0,0,0
2003,JOR,Jordan,215,0,0,0,0,150,365
2003,JPN,Japan,6673,4873,2339,64,0,0,13949
2003,KAZ,Kazakhstan,4040909,39323,6240150,40154,1801,114495,10476832
2003,KEN,Kenya,221743,106052,205351,12211,0,11480,556837
2003,KGZ,Kyrgyzstan,9292,256,12127,0,0,43,21718
2003,KHM,Cambodia,723179,2159676,87186,12937,0,0,2982978
2003,KNA,Saint Kitts and Nevis,0,0,0,0,0,0,0
2003,KOR,South Korea,2039,5496,279,0,0,0,7814
2003,KWT,Kuwait,0,0,0,0,0,2490,2490
2003,LAO,Laos,105453,204677,127096,2417,0,0,439643
2003,LBN,Lebanon,129,0,0,0,0,0,129
2003,LBR,Liberia,31295,14487,277,212,0,0,46271
2003,LBY,Libya,107,86,192,0,0,64,449
2003,LCA,Saint Lucia,0,0,0,0,0,0,0
2003,LIE,Liechtenstein,0,0,0,0,0,0,0
2003,LKA,Sri Lanka,57592,2596,5709,707,21,0,66625
2003,LSO,Lesotho,2508,10494,118080,21,0,0,131103
2003,LTU,Lithuania,5023,1867,342,171,43,0,7446
2003,LUX,Luxembourg,0,0,0,0,0,0,0
2003,LVA,Latvia,5967,9614,3434,257,451,0,19723
2003,MAC,Macao,0,0,0,0,0,0,0
2003,MAR,Morocco,1114,1073,1309,43,0,21,3560
2003,MDA,Moldova,943,193,21,0,0,0,1157
2003,MDG,Madagascar,114411,1481806,4482093,16654,597,10839,6106400
2003,MEX,Mexico,707573,1373277,346595,23174,2076,2828,2455523
2003,MKD,Macedonia,1072,64,106,0,0,0,1242
2003,MLI,Mali,2962247,549266,3042376,15260,42,858,6570049
2003,MLT,Malta,0,0,0,0,0,0,0
2003,MMR,Myanmar,831135,1972731,286932,10946,0,0,3101744
2003,MNE,Montenegro,1116,1781,64,279,0,0,3240
2003,MNG,Mongolia,429895,34967,1338329,3582,0,1803,1808576
2003,MNP,Northern Mariana Islands,0,0,0,0,0,0,0
2003,MOZ,Mozambique,2008151,12360026,5657561,586402,320,122977,20735437
2003,MRT,Mauritania,11247,128,18439,1653,0,1438,32905
2003,MSR,Montserrat,0,0,0,0,0,0,0
2003,MTQ,Martinique,0,0,0,0,0,0,0
2003,MUS,Mauritius,794,107,0,0,0,0,901
2003,MWI,Malawi,262825,292122,123723,8405,64,386,687525
2003,MYS,Malaysia,32928,9311,64,1350,192,0,43845
2003,MYT,Mayotte,0,0,0,0,0,0,0
2003,NAM,Namibia,171465,682504,2256319,21035,599,321,3132243
2003,NCL,New Caledonia,0,0,0,0,0,0,0
2003,NER,Niger,88222,343,214617,7276,0,579,311037
2003,NGA,Nigeria,5889771,3485190,2646906,127631,1366,386,12151250
2003,NIC,Nicaragua,84426,181102,66560,9893,171,107,342259
2003,NLD,Netherlands,0,0,21,0,0,0,21
2003,NOR,Norway,21,472,2597,64,0,0,3154
2003,NPL,Nepal,27990,152061,3756,63,64,0,183934
2003,NRU,Nauru,0,0,0,0,0,0,0
2003,NZL,New Zealand,279,213,386,21,21,21,941
2003,OMN,Oman,0,0,0,0,0,0,0
2003,PAK,Pakistan,144931,192,1286,1953,21,1244,149627
2003,PAN,Panama,88073,34451,3691,1543,21,107,127886
2003,PER,Peru,17958,54819,38482,299,107,3604,115269
2003,PHL,Philippines,137955,6989,7122,701,192,0,152959
2003,PLW,Palau,0,0,0,0,0,0,0
2003,PNG,Papua New Guinea,212190,53807,78862,2618,944,0,348421
2003,POL,Poland,16333,5150,2509,2209,622,0,26823
2003,PRI,Puerto Rico,620,343,644,0,21,0,1628
2003,PRK,North Korea,5150,21123,857,150,0,64,27344
2003,PRT,Portugal,177286,280105,12084,1779,129,1994,473377
2003,PRY,Paraguay,777039,1083160,607030,945089,169,0,3412487
2003,PSE,Palestina,21,43,0,0,0,0,64
2003,PYF,French Polynesia,0,0,0,0,0,0,0
2003,QAT,Qatar,0,0,0,0,0,0,0
2003,REU,Reunion,0,0,0,0,0,0,0
2003,ROU,Romania,35825,1414,1007,9937,63,0,48246
2003,RUS,Russia,3905377,13688035,4050011,589113,11988,69989,22314513
2003,RWA,Rwanda,2274,5494,23739,6418,21,0,37946
2003,SAU,Saudi Arabia,44109,0,171,0,43,20284,64607
2003,SDN,Sudan,2478770,1785190,5080005,71283,771,12986,9429005
2003,SEN,Senegal,388656,761757,1752430,7576,21,21,2910461
2003,SGP,Singapore,0,0,0,0,0,0,0
2003,SHN,Saint Helena,0,0,0,0,0,0,0
2003,SJM,Svalbard and Jan Mayen,0,0,0,0,0,0,0
2003,SLB,Solomon Islands,0,0,0,0,0,0,0
2003,SLE,Sierra Leone,494832,469863,45764,11461,471,21,1022412
2003,SLV,El Salvador,5859,2382,43,63,0,0,8347
2003,SMR,San Marino,0,0,0,0,0,0,0
2003,SOM,Somalia,70924,9078,64653,1157,836,0,146648
2003,SPM,Saint Pierre and Miquelon,0,0,0,0,0,0,0
2003,SRB,Serbia,33098,406,1609,106,0,0,35219
2003,SSD,South Sudan,649189,15409467,13448578,1096176,255,235,30603900
2003,STP,São Tomé and Príncipe,0,0,0,0,0,0,0
2003,SUR,Suriname,4250,26338,5516,364,21,0,36489
2003,SVK,Slovakia,987,42,0,0,128,0,1157
2003,SVN,Slovenia,279,450,85,0,0,0,814
2003,SWE,Sweden,0,0,0,0,0,0,0
2003,SWZ,Swaziland,21358,19962,35052,321,107,728,77528
2003,SYC,Seychelles,0,0,0,0,0,0,0
2003,SYR,Syria,47330,43,364,301,85,2597,50720
2003,TCA,Turks and Caicos Islands,0,0,0,0,0,0,0
2003,TCD,Chad,3413738,1907428,6858636,156590,2189,1544,12340125
2003,TGO,Togo,529948,471797,241854,428,129,0,1244156
2003,THA,Thailand,1078056,342039,59984,7301,105,0,1487485
2003,TJK,Tajikistan,12966,21,4636,107,0,1331,19061
2003,TKL,Tokelau,0,0,0,0,0,0,0
2003,TKM,Turkmenistan,83180,172,235565,943,0,72145,392005
2003,TLS,Timor-Leste,4140,278,0,0,86,0,4504
2003,TON,Tonga,0,0,0,0,0,0,0
2003,TTO,Trinidad and Tobago,2039,493,21,0,21,0,2574
2003,TUN,Tunisia,1286,365,42,0,0,1115,2808
2003,TUR,Turkey,335055,2617,5810,1070,809,1583,346944
2003,TUV,Tuvalu,0,0,0,0,0,0,0
2003,TWN,Taiwan,1201,85,0,21,64,0,1371
2003,TZA,Tanzania,1921460,9892967,4197619,1339915,362,5277,17357600
2003,UGA,Uganda,1048084,2015205,1352641,14539,171,0,4430640
2003,UKR,Ukraine,424703,26094,8709,6372,5320,0,471198
2003,UMI,United States Minor Outlying Islands,0,0,0,0,0,0,0
2003,URY,Uruguay,15812,3151,16029,1307,149,0,36448
2003,USA,United States,921886,837997,994091,62494,3767,34743,2854978
2003,UZB,Uzbekistan,40140,0,9743,321,0,7274,57478
2003,VCT,Saint Vincent and the Grenadines,0,0,0,0,0,0,0
2003,VEN,Venezuela,710613,609668,1827044,333895,683,193,3482096
2003,VGB,British Virgin Islands,0,0,0,0,0,0,0
2003,VIR,"Virgin Islands, U.S.",0,0,0,0,0,0,0
2003,VNM,Vietnam,498557,256651,93059,3001,84,0,851352
2003,VUT,Vanuatu,279,515,21,0,0,86,901
2003,WLF,Wallis and Futuna,0,0,0,0,0,0,0
2003,WSM,Samoa,0,0,0,0,0,0,0
2003,XAD,Akrotiri and Dhekelia,0,0,0,0,0,0,0
2003,XKO,Kosovo,644,537,193,0,0,0,1374
2003,XNC,Northern Cyprus,773,0,579,0,0,21,1373
2003,YEM,Yemen,0,0,0,0,0,0,0
2003,ZAF,South Africa,629526,354656,2782428,28502,4719,5319,3805150
2003,ZMB,Zambia,3821694,15976614,4750078,652366,1002,321,25202075
2003,ZWE,Zimbabwe,588202,798717,1217005,5899,171,835,2610829
2004,AFG,Afghanistan,9229,64,8456,537,0,11161,29447
2004,AGO,Angola,1265879,22729046,17110827,80575,2485,880,41189692
2004,ALA,Åland,0,0,0,0,0,0,0
2004,ALB,Albania,1480,0,64,0,0,0,1544
2004,AND,Andorra,0,0,0,0,0,0,0
2004,ARE,United Arab Emirates,0,0,0,0,0,0,0
2004,ARG,Argentina,1651492,1050873,1422022,694307,1390,5020,4825104
2004,ARM,Armenia,11267,2510,686,0,21,43,14527
2004,ASM,American Samoa,0,0,0,0,0,0,0
2004,ATF,French Southern Territories,0,0,0,0,0,0,0
2004,ATG,Antigua and Barbuda,0,0,0,0,0,0,0
2004,AUS,Australia,1161902,5807351,56762215,236077,361,45569,64013475
2004,AUT,Austria,4851,0,21,193,42,0,5107
2004,AZE,Azerbaijan,227752,6652,20130,128,0,234,254896
2004,BDI,Burundi,16459,13586,37567,1093,0,0,68705
2004,BEL,Belgium,21,64,0,64,0,0,149
2004,BEN,Benin,420023,701952,961582,3262,277,149,2087245
2004,BES,"Bonaire, Sint Eustatius and Saba",0,0,0,0,0,0,0
2004,BFA,Burkina Faso,2158291,262977,1316647,4075,42,0,3742032
2004,BGD,Bangladesh,5901,8220,5215,300,0,0,19636
2004,BGR,Bulgaria,129409,724,234,256,190,21,130834
2004,BHR,Bahrain,0,0,0,0,0,0,0
2004,BHS,Bahamas,942,37285,4314,3753,129,0,46423
2004,BIH,Bosnia and Herzegovina,6032,3369,1309,0,0,0,10710
2004,BLR,Belarus,12666,5601,1114,107,236,0,19724
2004,BLZ,Belize,1095,2017,2639,1438,0,0,7189
2004,BMU,Bermuda,0,0,0,0,0,0,0
2004,BOL,Bolivia,1185127,3190079,1313085,814413,751,64,6503519
2004,BRA,Brazil,5871209,3778112,9691907,1170522,12929,3775,20528454
2004,BRB,Barbados,0,0,0,0,0,0,0
2004,BRN,Brunei,236,85,0,0,0,0,321
2004,BTN,Bhutan,149,2703,300,0,0,0,3152
2004,BWA,Botswana,124331,151248,1511110,7811,0,1480,1795980
2004,CAF,Central African Republic,466408,17333690,3444343,10016,277,21,21254755
2004,CAN,Canada,27560,1658837,551973,66003,0,12190,2316563
2004,CHE,Switzerland,0,0,0,0,0,0,0
2004,CHL,Chile,11955,10063,37627,128,43,1608,61424
2004,CHN,China,1675774,463701,125484,29101,13798,9785,2317643
2004,CIV,Côte d'Ivoire,447046,1249825,327849,1265,298,0,2026283
2004,CMR,Cameroon,597738,3307499,718609,59758,428,21,4684053
2004,COD,Democratic Republic of the Congo,3356243,28765181,3708983,1776831,5786,1093,37614117
2004,COG,Republic of Congo,472610,1763418,998395,28052,236,0,3262711
2004,COL,Colombia,227057,410722,3066926,271383,490,86,3976664
2004,COM,Comoros,21,0,0,0,0,0,21
2004,CPV,Cape Verde,0,0,0,0,0,0,0
2004,CRI,Costa Rica,20735,10325,1802,193,43,0,33098
2004,CUB,Cuba,365837,70706,68580,7465,149,0,512737
2004,CYM,Cayman Islands,0,0,0,0,0,0,0
2004,CYP,Cyprus,537,21,644,0,0,193,1395
2004,CZE,Czech Republic,792,0,0,0,42,0,834
2004,DEU,Germany,686,106,0,0,107,0,899
2004,DJI,Djibouti,0,0,0,0,0,0,0
2004,DMA,Dominica,0,0,0,0,0,0,0
2004,DNK,Denmark,7686,256,300,43,21,0,8306
2004,DOM,Dominican Republic,6762,1974,106,385,0,0,9227
2004,DZA,Algeria,48210,25949,32794,106,0,6329,113388
2004,ECU,Ecuador,14014,3923,8756,642,0,0,27335
2004,EGY,Egypt,18760,0,0,42,321,0,19123
2004,ERI,Eritrea,12127,150,5495,106,128,42,18048
2004,ESH,Western Sahara,0,0,0,0,0,0,0
2004,ESP,Spain,121214,62614,14270,557,172,622,199449
2004,EST,Estonia,814,645,557,0,0,0,2016
2004,ETH,Ethiopia,552897,3976489,2153455,35758,191,4143,6722933
2004,FIN,Finland,0,0,0,0,0,0,0
2004,FJI,Fiji,1181,0,0,0,0,0,1181
2004,FRA,France,54650,4159,3475,63,256,21,62624
2004,FRO,Faroe Islands,0,0,0,0,0,0,0
2004,FSM,Micronesia,0,0,0,0,0,0,0
2004,GAB,Gabon,28118,187349,213412,386,0,0,429265
2004,GBR,United Kingdom,473,0,0,0,0,0,473
2004,GEO,Georgia,16807,966,1094,0,0,43,18910
2004,GGY,Guernsey,0,0,0,0,0,0,0
2004,GHA,Ghana,1214197,2767358,1428549,18866,792,236,5429998
2004,GIN,Guinea,586963,2653355,425256,23114,233,0,3688921
2004,GLP,Guadeloupe,0,0,0,0,0,0,0
2004,GMB,Gambia,177011,38981,45442,13051,0,837,275322
2004,GNB,Guinea-Bissau,63968,529110,9635,22126,0,127,624966
2004,GNQ,Equatorial Guinea,0,0,0,0,0,0,0
2004,GRC,Greece,54133,622,2575,106,127,150,57713
2004,GRD,Grenada,0,0,0,0,0,0,0
2004,GRL,Greenland,0,0,0,0,0,0,0
2004,GTM,Guatemala,105929,40631,5944,708,169,0,153381
2004,GUF,French Guiana,407,2404,299,1266,1094,0,5470
2004,GUM,Guam,0,0,0,0,0,0,0
2004,GUY,Guyana,10085,21009,44709,3282,429,0,79514
2004,HKG,Hong Kong,579,641,21,192,0,0,1433
2004,HND,Honduras,21055,18521,19918,2144,150,0,61788
2004,HRV,Croatia,3152,385,257,0,0,0,3794
2004,HTI,Haiti,1073,0,3565,127,0,0,4765
2004,HUN,Hungary,17557,730,106,85,106,0,18584
2004,IDN,Indonesia,1633757,535353,248139,28043,4500,0,2449792
2004,IMN,Isle of Man,0,0,0,0,0,0,0
2004,IND,India,2467003,1417664,136365,5660,6610,85,4033387
2004,IRL,Ireland,0,0,0,0,0,0,0
2004,IRN,Iran,238847,149,15279,2188,427,72289,329179
2004,IRQ,Iraq,37176,0,3580,322,193,13066,54337
2004,ISL,Iceland,0,0,0,0,0,0,0
2004,ISR,Israel,664,107,1802,0,0,451,3024
2004,ITA,Italy,155196,1324,11783,84,106,384,168877
2004,JAM,Jamaica,150,21,0,0,0,0,171
2004,JEY,Jersey,0,0,0,0,0,0,0
2004,JOR,Jordan,21,0,0,0,0,43,64
2004,JPN,Japan,4378,2039,107,21,215,0,6760
2004,KAZ,Kazakhstan,3121932,28911,9522127,42519,639,710664,13426792
2004,KEN,Kenya,91026,35050,60530,3300,0,1909,191815
2004,KGZ,Kyrgyzstan,9251,580,12770,21,0,1031,23653
2004,KHM,Cambodia,1160724,2918493,98436,40283,21,0,4217957
2004,KNA,Saint Kitts and Nevis,0,0,0,0,0,0,0
2004,KOR,South Korea,5300,4529,278,21,21,21,10170
2004,KWT,Kuwait,0,0,42,0,0,451,493
2004,LAO,Laos,200621,744300,476366,4717,0,0,1426004
2004,LBN,Lebanon,129,0,129,0,0,0,258
2004,LBR,Liberia,23031,5235,385,902,0,0,29553
2004,LBY,Libya,0,0,21,0,0,0,21
2004,LCA,Saint Lucia,0,0,0,0,0,0,0
2004,LIE,Liechtenstein,0,0,0,0,0,0,0
2004,LKA,Sri Lanka,66371,4376,7040,277,0,0,78064
2004,LSO,Lesotho,1094,2443,32715,42,0,0,36294
2004,LTU,Lithuania,1157,171,21,21,0,0,1370
2004,LUX,Luxembourg,0,0,0,0,0,0,0
2004,LVA,Latvia,987,1481,256,21,0,0,2745
2004,MAC,Macao,0,0,0,0,0,0,0
2004,MAR,Morocco,6694,3197,1415,0,43,86,11435
2004,MDA,Moldova,17344,107,0,21,0,0,17472
2004,MDG,Madagascar,96010,995154,2442840,26876,234,11932,3573046
2004,MEX,Mexico,432232,323977,196270,8254,2781,4352,967866
2004,MKD,Macedonia,3026,149,515,0,0,21,3711
2004,MLI,Mali,5100758,781487,3658427,28206,171,128,9569177
2004,MLT,Malta,0,0,0,0,0,0,0
2004,MMR,Myanmar,1081812,3447350,814522,14955,128,0,5358767
2004,MNE,Montenegro,21,21,0,0,0,0,42
2004,MNG,Mongolia,289207,10580,1107016,751,0,385,1407939
2004,MNP,Northern Mariana Islands,0,0,0,0,0,0,0
2004,MOZ,Mozambique,1679874,11783083,5587972,386361,298,86003,19523591
2004,MRT,Mauritania,160928,172,100008,1458,21,1052,263639
2004,MSR,Montserrat,0,0,0,0,0,0,0
2004,MTQ,Martinique,0,0,0,0,0,0,0
2004,MUS,Mauritius,901,0,0,0,0,0,901
2004,MWI,Malawi,191693,190094,79625,12826,21,149,474408
2004,MYS,Malaysia,83564,13348,535,1563,170,0,99180
2004,MYT,Mayotte,0,0,0,0,0,0,0
2004,NAM,Namibia,194863,826088,2623277,26681,749,900,3672558
2004,NCL,New Caledonia,4959,2469,3177,21,0,0,10626
2004,NER,Niger,76976,193,122827,8735,0,364,209095
2004,NGA,Nigeria,6025225,2179079,2270458,107707,1346,148,10583963
2004,NIC,Nicaragua,45223,46041,16782,7661,149,0,115856
2004,NLD,Netherlands,0,0,0,0,0,0,0
2004,NOR,Norway,0,0,0,0,0,0,0
2004,NPL,Nepal,22688,131477,7511,128,21,0,161825
2004,NRU,Nauru,0,0,0,0,0,0,0
2004,NZL,New Zealand,0,64,772,0,0,0,836
2004,OMN,Oman,0,0,64,0,0,21,85
2004,PAK,Pakistan,242458,3069,7619,7298,0,987,261431
2004,PAN,Panama,60982,26877,5258,642,0,106,93865
2004,PER,Peru,8692,24725,15003,577,150,4527,53674
2004,PHL,Philippines,87630,8104,3300,705,0,0,99739
2004,PLW,Palau,0,0,0,0,0,0,0
2004,PNG,Papua New Guinea,413369,155342,107007,15303,812,0,691833
2004,POL,Poland,6567,191,257,0,42,43,7100
2004,PRI,Puerto Rico,236,21,815,0,0,0,1072
2004,PRK,North Korea,7039,88261,879,192,21,107,96499
2004,PRT,Portugal,37649,59798,9935,171,150,63,107766
2004,PRY,Paraguay,523595,659938,374699,349350,85,0,1907667
2004,PSE,Palestina,236,0,386,0,0,21,643
2004,PYF,French Polynesia,0,0,0,0,0,0,0
2004,QAT,Qatar,0,0,64,0,0,214,278
2004,REU,Reunion,0,0,0,0,0,0,0
2004,ROU,Romania,118586,1799,2764,1414,150,0,124713
2004,RUS,Russia,4980944,3528286,1710486,231521,12912,31889,10496038
2004,RWA,Rwanda,1547,2769,18653,3670,0,0,26639
2004,SAU,Saudi Arabia,64484,0,85,0,21,19704,84294
2004,SDN,Sudan,2524598,1708617,5277210,60077,707,6568,9577777
2004,SEN,Senegal,762427,1566425,2521443,10429,0,0,4860724
2004,SGP,Singapore,0,0,0,0,0,0,0
2004,SHN,Saint Helena,0,0,0,0,0,0,0
2004,SJM,Svalbard and Jan Mayen,0,0,0,0,0,0,0
2004,SLB,Solomon Islands,0,0,0,0,0,0,0
2004,SLE,Sierra Leone,560215,480898,33637,9142,322,0,1084214
2004,SLV,El Salvador,3004,5429,63,0,0,0,8496
2004,SMR,San Marino,0,0,0,0,0,0,0
2004,SOM,Somalia,10260,1545,7342,322,85,0,19554
2004,SPM,Saint Pierre and Miquelon,0,0,0,0,0,0,0
2004,SRB,Serbia,56111,86,3476,42,0,0,59715
2004,SSD,South Sudan,653333,14261059,15853314,1089239,191,0,31857136
2004,STP,São Tomé and Príncipe,0,0,0,0,0,0,0
2004,SUR,Suriname,3047,18546,30823,277,42,0,52735
2004,SVK,Slovakia,2703,0,0,0,214,0,2917
2004,SVN,Slovenia,0,21,0,0,0,0,21
2004,SWE,Sweden,21,0,0,0,0,0,21
2004,SWZ,Swaziland,18137,16764,30587,342,192,643,66665
2004,SYC,Seychelles,0,0,0,0,0,0,0
2004,SYR,Syria,19791,1653,192,85,0,6223,27944
2004,TCA,Turks and Caicos Islands,0,0,0,0,0,0,0
2004,TCD,Chad,3938661,1884980,6604637,166528,1028,169170,12765004
2004,TGO,Togo,335706,314624,184263,686,106,0,835385
2004,THA,Thailand,1432612,801273,203648,7854,321,0,2445708
2004,TJK,Tajikistan,20135,0,2770,21,0,21,22947
2004,TKL,Tokelau,0,0,0,0,0,0,0
2004,TKM,Turkmenistan,66586,42,156808,322,0,44627,268385
2004,TLS,Timor-Leste,19942,1372,21,0,0,0,21335
2004,TON,Tonga,0,0,0,0,0,0,0
2004,TTO,Trinidad and Tobago,644,0,0,0,0,0,644
2004,TUN,Tunisia,3004,0,0,43,0,171,3218
2004,TUR,Turkey,401165,2937,3965,1521,170,1735,411493
2004,TUV,Tuvalu,0,0,0,0,0,0,0
2004,TWN,Taiwan,0,772,0,43,0,0,815
2004,TZA,Tanzania,1383772,8623748,3686095,1331224,254,3559,15028652
2004,UGA,Uganda,974438,1398233,822952,12094,385,0,3208102
2004,UKR,Ukraine,1119531,7353,9668,4649,6041,21,1147263
2004,UMI,United States Minor Outlying Islands,0,0,0,0,0,0,0
2004,URY,Uruguay,23060,9780,12356,5447,128,0,50771
2004,USA,United States,901353,1802782,1212231,79458,1153,21800,4018777
2004,UZB,Uzbekistan,24643,0,29280,343,0,9528,63794
2004,VCT,Saint Vincent and the Grenadines,0,0,0,0,0,0,0
2004,VEN,Venezuela,244489,156625,1816138,304596,428,64,2522340
2004,VGB,British Virgin Islands,0,0,0,0,0,0,0
2004,VIR,"Virgin Islands, U.S.",0,0,0,0,0,0,0
2004,VNM,Vietnam,620756,339603,98295,2694,171,0,1061519
2004,VUT,Vanuatu,0,0,0,0,0,0,0
2004,WLF,Wallis and Futuna,0,0,0,0,0,0,0
2004,WSM,Samoa,0,0,0,0,0,0,0
2004,XAD,Akrotiri and Dhekelia,0,0,0,0,0,0,0
2004,XKO,Kosovo,644,43,0,0,0,0,687
2004,XNC,Northern Cyprus,21,0,85,0,0,0,106
2004,YEM,Yemen,0,0,0,0,0,0,0
2004,ZAF,South Africa,467978,254411,2420684,21138,4438,4803,3173452
2004,ZMB,Zambia,3847239,15639923,5065084,626863,1195,42,25180346
2004,ZWE,Zimbabwe,635091,1196293,1725644,8711,363,1071,3567173
2005,AFG,Afghanistan,6567,21,2765,107,0,2767,12227
2005,AGO,Angola,1131288,22831260,16381507,143410,2616,2166,40492247
2005,ALA,Åland,0,0,0,0,0,0,0
2005,ALB,Albania,8158,150,364,42,0,0,8714
2005,AND,Andorra,0,0,0,0,0,0,0
2005,ARE,United Arab Emirates,0,0,0,0,0,21,21
2005,ARG,Argentina,1100181,690271,1199656,543957,1263,7163,3542491
2005,ARM,Armenia,8024,665,3455,0,0,0,12144
2005,ASM,American Samoa,0,0,0,0,0,0,0
2005,ATF,French Southern Territories,0,0,0,0,0,0,0
2005,ATG,Antigua and Barbuda,0,0,0,0,0,0,0
2005,AUS,Australia,719515,3684596,23385903,196649,426,12234,27999323
2005,AUT,Austria,2726,944,86,0,43,0,3799
2005,AZE,Azerbaijan,125980,2315,8583,106,86,298,137368
2005,BDI,Burundi,9312,9096,22534,385,0,0,41327
2005,BEL,Belgium,0,0,0,0,0,0,0
2005,BEN,Benin,758196,1513130,1255192,1393,513,64,3528488
2005,BES,"Bonaire, Sint Eustatius and Saba",0,0,0,0,0,0,0
2005,BFA,Burkina Faso,2265552,320527,1408008,8089,0,0,4002176
2005,BGD,Bangladesh,2812,21251,23054,64,0,0,47181
2005,BGR,Bulgaria,102475,2939,148,21,85,42,105710
2005,BHR,Bahrain,0,0,0,0,0,0,0
2005,BHS,Bahamas,428,20604,1416,1048,0,0,23496
2005,BIH,Bosnia and Herzegovina,322,966,128,0,0,0,1416
2005,BLR,Belarus,32242,6395,1093,106,149,0,39985
2005,BLZ,Belize,4763,28162,7383,1566,21,0,41895
2005,BMU,Bermuda,0,0,0,0,0,0,0
2005,BOL,Bolivia,953386,2386615,1459165,988459,600,1223,5789448
2005,BRA,Brazil,5887675,5218909,9834108,1565296,13273,3624,22522885
2005,BRB,Barbados,0,0,0,0,0,0,0
2005,BRN,Brunei,0,0,0,0,0,0,0
2005,BTN,Bhutan,772,4204,86,0,0,0,5062
2005,BWA,Botswana,85778,97434,2499759,108553,21,4570,2796115
2005,CAF,Central African Republic,374101,19567747,3616344,9421,278,42,23567933
2005,CAN,Canada,106061,1006535,316018,77360,85,13136,1519195
2005,CHE,Switzerland,0,21,0,0,85,0,106
2005,CHL,Chile,19769,21030,78245,1028,85,662,120819
2005,CHN,China,2592485,300662,204301,54346,23885,29254,3204933
2005,CIV,Côte d'Ivoire,412315,3441427,511849,8326,792,0,4374709
2005,CMR,Cameroon,504341,5121792,910773,62524,643,128,6600201
2005,COD,Democratic Republic of the Congo,3415148,28382808,3639082,1863564,5416,578,37306596
2005,COG,Republic of Congo,552915,2028069,1209877,28116,235,0,3819212
2005,COL,Colombia,66470,100727,1811645,214418,214,0,2193474
2005,COM,Comoros,171,10024,107,21,0,0,10323
2005,CPV,Cape Verde,0,0,0,0,0,0,0
2005,CRI,Costa Rica,9336,8994,494,256,0,0,19080
2005,CUB,Cuba,210793,76136,32837,6759,84,0,326609
2005,CYM,Cayman Islands,0,0,0,0,0,0,0
2005,CYP,Cyprus,730,0,1052,0,21,301,2104
2005,CZE,Czech Republic,838,322,214,0,858,0,2232
2005,DEU,Germany,214,64,21,0,215,0,514
2005,DJI,Djibouti,0,0,0,0,0,0,0
2005,DMA,Dominica,0,0,0,0,0,0,0
2005,DNK,Denmark,42,0,0,0,0,0,42
2005,DOM,Dominican Republic,25287,32924,3390,5944,21,21,67587
2005,DZA,Algeria,30932,52633,26785,148,21,4355,114874
2005,ECU,Ecuador,15688,14677,16461,3497,21,2081,52425
2005,EGY,Egypt,19856,0,0,85,428,0,20369
2005,ERI,Eritrea,11891,0,4549,0,128,107,16675
2005,ESH,Western Sahara,0,0,0,0,0,0,0
2005,ESP,Spain,33633,124519,27578,320,63,600,186713
2005,EST,Estonia,0,0,0,0,0,0,0
2005,ETH,Ethiopia,621154,4426600,2718456,35265,279,14596,7816350
2005,FIN,Finland,85,21,0,0,0,0,106
2005,FJI,Fiji,43,0,0,0,0,0,43
2005,FRA,France,30025,12706,16548,192,386,21,59878
2005,FRO,Faroe Islands,0,0,0,0,0,0,0
2005,FSM,Micronesia,0,0,0,0,0,0,0
2005,GAB,Gabon,15689,116257,164320,301,0,0,296567
2005,GBR,United Kingdom,107,43,1009,923,0,0,2082
2005,GEO,Georgia,28678,1052,687,0,21,0,30438
2005,GGY,Guernsey,0,0,0,0,0,0,0
2005,GHA,Ghana,1961289,4851776,2096165,61777,447,363,8971817
2005,GIN,Guinea,601796,3761204,657068,28180,147,21,5048416
2005,GLP,Guadeloupe,0,0,0,0,0,0,0
2005,GMB,Gambia,187396,43144,30756,7810,0,129,269235
2005,GNB,Guinea-Bissau,31294,464754,12575,13626,0,21,522270
2005,GNQ,Equatorial Guinea,0,0,0,0,0,0,0
2005,GRC,Greece,29323,385,2489,43,171,493,32904
2005,GRD,Grenada,0,0,0,0,0,0,0
2005,GRL,Greenland,0,0,0,0,0,0,0
2005,GTM,Guatemala,355899,243137,51278,1631,170,342,652457
2005,GUF,French Guiana,171,2059,1223,1331,64,0,4848
2005,GUM,Guam,0,0,0,0,0,0,0
2005,GUY,Guyana,12063,24080,25865,3048,256,0,65312
2005,HKG,Hong Kong,64,42,21,0,0,0,127
2005,HND,Honduras,117093,324857,132592,3989,107,0,578638
2005,HRV,Croatia,2705,1459,278,21,0,0,4463
2005,HTI,Haiti,536,107,1008,1524,0,0,3175
2005,HUN,Hungary,8884,84,214,0,21,21,9224
2005,IDN,Indonesia,524984,162698,75902,10122,2939,0,776645
2005,IMN,Isle of Man,0,0,0,0,0,0,0
2005,IND,India,2503211,759698,69049,7420,8801,85,3348264
2005,IRL,Ireland,0,0,43,449,0,0,492
2005,IRN,Iran,198404,663,15189,2961,448,90495,308160
2005,IRQ,Iraq,24292,0,3687,276,21,25111,53387
2005,ISL,Iceland,0,0,0,0,0,0,0
2005,ISR,Israel,2188,300,1695,0,0,343,4526
2005,ITA,Italy,52033,1522,2360,21,1158,213,57307
2005,JAM,Jamaica,707,1243,493,0,0,0,2443
2005,JEY,Jersey,0,0,0,0,0,0,0
2005,JOR,Jordan,0,0,0,0,0,2769,2769
2005,JPN,Japan,6998,2791,730,192,43,0,10754
2005,KAZ,Kazakhstan,2730843,21332,9756925,75061,621,250412,12835194
2005,KEN,Kenya,131726,80060,73771,6606,107,2512,294782
2005,KGZ,Kyrgyzstan,10539,815,17943,0,0,1114,30411
2005,KHM,Cambodia,855392,1247186,67354,50798,0,0,2220730
2005,KNA,Saint Kitts and Nevis,0,0,0,0,0,0,0
2005,KOR,South Korea,2209,7876,128,107,21,86,10427
2005,KWT,Kuwait,0,0,43,0,0,386,429
2005,LAO,Laos,263059,394968,275576,4737,0,0,938340
2005,LBN,Lebanon,0,0,0,0,0,0,0
2005,LBR,Liberia,4723,364,472,0,0,0,5559
2005,LBY,Libya,0,0,0,0,0,0,0
2005,LCA,Saint Lucia,0,0,0,0,0,0,0
2005,LIE,Liechtenstein,0,0,0,0,0,0,0
2005,LKA,Sri Lanka,80129,4378,5106,1524,0,0,91137
2005,LSO,Lesotho,2210,3048,55467,21,0,0,60746
2005,LTU,Lithuania,1695,0,63,0,0,0,1758
2005,LUX,Luxembourg,0,0,0,0,0,0,0
2005,LVA,Latvia,193,0,43,0,0,0,236
2005,MAC,Macao,0,0,0,0,0,0,0
2005,MAR,Morocco,2081,6181,601,0,0,0,8863
2005,MDA,Moldova,35309,686,85,85,43,0,36208
2005,MDG,Madagascar,153912,1857205,3948772,36919,642,11500,6008950
2005,MEX,Mexico,684945,1242223,550503,16838,1884,2615,2499008
2005,MKD,Macedonia,3263,150,1202,0,0,21,4636
2005,MLI,Mali,4504163,881474,3621378,12728,170,171,9020084
2005,MLT,Malta,0,0,0,0,0,0,0
2005,MMR,Myanmar,857839,2010600,397628,8687,42,0,3274796
2005,MNE,Montenegro,0,0,0,0,0,0,0
2005,MNG,Mongolia,308653,9896,715842,472,0,5151,1040014
2005,MNP,Northern Mariana Islands,0,0,0,0,0,0,0
2005,MOZ,Mozambique,2032706,13069342,5295995,661597,470,127802,21187912
2005,MRT,Mauritania,103442,471,194457,1908,0,623,300901
2005,MSR,Montserrat,0,0,0,0,0,0,0
2005,MTQ,Martinique,0,0,0,0,0,0,0
2005,MUS,Mauritius,0,0,0,0,0,0,0
2005,MWI,Malawi,219420,295828,119701,27877,127,1245,664198
2005,MYS,Malaysia,94531,16463,1996,1285,407,0,114682
2005,MYT,Mayotte,0,0,0,0,0,0,0
2005,NAM,Namibia,166679,718051,2536363,46193,193,922,3468401
2005,NCL,New Caledonia,1717,1502,1611,150,0,0,4980
2005,NER,Niger,104535,0,139418,8155,0,107,252215
2005,NGA,Nigeria,5916823,4427654,2984483,140851,2957,535,13473303
2005,NIC,Nicaragua,107604,179493,103464,12640,128,171,403500
2005,NLD,Netherlands,0,0,0,0,0,0,0
2005,NOR,Norway,0,0,0,0,0,0,0
2005,NPL,Nepal,26317,142105,3326,277,0,21,172046
2005,NRU,Nauru,0,0,0,0,0,0,0
2005,NZL,New Zealand,0,0,0,0,0,0,0
2005,OMN,Oman,0,0,0,0,0,0,0
2005,PAK,Pakistan,358801,12942,4934,2403,171,386,379637
2005,PAN,Panama,12642,1069,729,84,21,21,14566
2005,PER,Peru,44173,170195,66795,1540,407,2936,286046
2005,PHL,Philippines,139930,14562,6197,491,42,0,161222
2005,PLW,Palau,0,0,0,0,0,0,0
2005,PNG,Papua New Guinea,134995,22634,35436,3041,879,0,196985
2005,POL,Poland,9014,1780,1395,0,1631,0,13820
2005,PRI,Puerto Rico,558,129,793,21,0,0,1501
2005,PRK,North Korea,10279,41280,1072,192,0,21,52844
2005,PRT,Portugal,63601,258444,8087,965,577,555,332229
2005,PRY,Paraguay,720970,1166336,606404,496542,84,86,2990422
2005,PSE,Palestina,107,0,21,0,0,86,214
2005,PYF,French Polynesia,0,0,0,0,0,0,0
2005,QAT,Qatar,0,0,0,0,21,0,21
2005,REU,Reunion,0,0,0,0,0,0,0
2005,ROU,Romania,152399,2036,1649,4096,234,0,160414
2005,RUS,Russia,6493197,2905773,2706574,542375,17117,61856,12726892
2005,RWA,Rwanda,3520,4721,13910,4831,0,0,26982
2005,SAU,Saudi Arabia,77641,0,879,42,64,33377,112003
2005,SDN,Sudan,2727218,1624901,5552341,94832,620,3219,10003131
2005,SEN,Senegal,742112,1783983,2566908,8434,0,0,5101437
2005,SGP,Singapore,0,0,0,21,0,0,21
2005,SHN,Saint Helena,0,0,0,0,0,0,0
2005,SJM,Svalbard and Jan Mayen,0,0,0,0,0,0,0
2005,SLB,Solomon Islands,0,0,0,0,0,0,0
2005,SLE,Sierra Leone,354121,545318,27412,3219,472,0,930542
2005,SLV,El Salvador,3431,3580,21,0,0,0,7032
2005,SMR,San Marino,0,0,0,0,0,0,0
2005,SOM,Somalia,12792,879,12512,215,214,0,26612
2005,SPM,Saint Pierre and Miquelon,0,0,0,0,0,0,0
2005,SRB,Serbia,12340,86,469,21,0,0,12916
2005,SSD,South Sudan,744242,16272868,16429353,1090720,577,64,34537824
2005,STP,São Tomé and Príncipe,0,0,0,0,0,0,0
2005,SUR,Suriname,258,3346,2640,43,0,0,6287
2005,SVK,Slovakia,1630,107,0,0,21,0,1758
2005,SVN,Slovenia,0,0,0,0,0,0,0
2005,SWE,Sweden,107,0,0,0,0,0,107
2005,SWZ,Swaziland,23957,23826,34325,170,0,600,82878
2005,SYC,Seychelles,0,0,0,0,0,0,0
2005,SYR,Syria,10669,0,21,0,0,1545,12235
2005,TCA,Turks and Caicos Islands,0,0,0,0,0,0,0
2005,TCD,Chad,3608824,1446990,7561585,185654,1800,375543,13180396
2005,TGO,Togo,1059746,774401,298373,5237,236,0,2137993
2005,THA,Thailand,1513252,488207,116002,6486,64,0,2124011
2005,TJK,Tajikistan,3498,0,1309,107,0,0,4914
2005,TKL,Tokelau,0,0,0,0,0,0,0
2005,TKM,Turkmenistan,57315,21,71307,685,0,23846,153174
2005,TLS,Timor-Leste,21785,514,0,64,0,0,22363
2005,TON,Tonga,0,0,0,0,0,0,0
2005,TTO,Trinidad and Tobago,987,42,21,21,0,0,1071
2005,TUN,Tunisia,235,215,0,0,0,64,514
2005,TUR,Turkey,399278,1737,2588,2486,748,1283,408120
2005,TUV,Tuvalu,0,0,0,0,0,0,0
2005,TWN,Taiwan,1545,0,0,0,21,0,1566
2005,TZA,Tanzania,1666545,10524053,3870717,1440596,425,5235,17507571
2005,UGA,Uganda,1279504,2747796,1516033,29393,127,0,5572853
2005,UKR,Ukraine,2909428,47018,37315,4476,31332,171,3029740
2005,UMI,United States Minor Outlying Islands,0,0,0,0,0,0,0
2005,URY,Uruguay,11780,10189,7145,6266,64,0,35444
2005,USA,United States,734787,1455851,1986202,103576,2782,16558,4299756
2005,UZB,Uzbekistan,37884,21,39024,106,0,7726,84761
2005,VCT,Saint Vincent and the Grenadines,0,0,0,0,0,0,0
2005,VEN,Venezuela,389746,239866,2056360,322308,771,0,3009051
2005,VGB,British Virgin Islands,0,43,0,43,0,0,86
2005,VIR,"Virgin Islands, U.S.",0,0,0,0,0,0,0
2005,VNM,Vietnam,674315,240926,143788,2821,299,0,1062149
2005,VUT,Vanuatu,0,537,0,0,0,0,537
2005,WLF,Wallis and Futuna,0,0,0,0,0,0,0
2005,WSM,Samoa,0,0,0,0,0,0,0
2005,XAD,Akrotiri and Dhekelia,0,0,0,0,0,0,0
2005,XKO,Kosovo,1417,0,322,0,0,0,1739
2005,XNC,Northern Cyprus,1094,0,557,0,0,43,1694
2005,YEM,Yemen,0,0,0,0,0,0,0
2005,ZAF,South Africa,707364,405728,4042643,25670,4740,7896,5194041
2005,ZMB,Zambia,3795807,16542732,5139812,964438,1499,300,26444588
2005,ZWE,Zimbabwe,603965,1126487,1603069,8027,233,1198,3342979
2006,AFG,Afghanistan,2811,128,14509,192,0,771,18411
2006,AGO,Angola,1015619,22143607,13071986,87624,1927,1631,36322394
2006,ALA,Åland,0,0,0,0,0,0,0
2006,ALB,Albania,1009,236,107,0,0,21,1373
2006,AND,Andorra,0,0,0,0,0,0,0
2006,ARE,United Arab Emirates,0,0,0,0,0,86,86
2006,ARG,Argentina,1115215,727714,1031475,935709,1863,2721,3814697
2006,ARM,Armenia,17258,5452,2832,64,171,43,25820
2006,ASM,American Samoa,0,0,0,0,0,0,0
2006,ATF,French Southern Territories,0,0,0,0,0,0,0
2006,ATG,Antigua and Barbuda,0,0,0,0,0,0,0
2006,AUS,Australia,906544,6337582,50253825,183357,534,30866,57712708
2006,AUT,Austria,365,215,0,64,1438,0,2082
2006,AZE,Azerbaijan,248832,16871,34108,429,21,149,300410
2006,BDI,Burundi,2983,11117,12342,127,0,0,26569
2006,BEL,Belgium,451,0,0,0,0,0,451
2006,BEN,Benin,381255,970042,1037675,1887,128,43,2391030
2006,BES,"Bonaire, Sint Eustatius and Saba",0,0,0,0,0,0,0
2006,BFA,Burkina Faso,1339707,281157,1265175,4076,0,0,2890115
2006,BGD,Bangladesh,16485,80240,80067,407,0,0,177199
2006,BGR,Bulgaria,194539,3985,557,986,212,64,200343
2006,BHR,Bahrain,0,0,0,0,0,0,0
2006,BHS,Bahamas,513,10539,2038,1029,0,0,14119
2006,BIH,Bosnia and Herzegovina,1589,4787,4743,43,0,0,11162
2006,BLR,Belarus,44947,23481,2057,342,42,0,70869
2006,BLZ,Belize,1307,10024,2853,278,0,0,14462
2006,BMU,Bermuda,0,0,0,0,0,0,0
2006,BOL,Bolivia,625018,2008771,1335498,746860,406,558,4717111
2006,BRA,Brazil,4134899,2423709,5535124,431037,7720,3368,12535857
2006,BRB,Barbados,0,0,0,0,0,0,0
2006,BRN,Brunei,0,0,0,0,0,0,0
2006,BTN,Bhutan,620,3754,255,0,0,0,4629
2006,BWA,Botswana,259930,282746,4588327,30718,85,3774,5165580
2006,CAF,Central African Republic,454105,17912102,3666234,14679,642,106,22047868
2006,CAN,Canada,61047,1433915,283712,107800,85,10215,1896774
2006,CHE,Switzerland,0,0,0,0,0,0,0
2006,CHL,Chile,5985,14551,12874,64,64,190,33728
2006,CHN,China,3655975,240001,165959,36183,34832,15518,4148468
2006,CIV,Côte d'Ivoire,411608,2680674,474887,3751,876,0,3571796
2006,CMR,Cameroon,559655,3441921,747890,71670,342,127,4821605
2006,COD,Democratic Republic of the Congo,3224272,29215615,3581703,1839277,5790,492,37867149
2006,COG,Republic of Congo,498461,2053923,1339168,17040,214,0,3908806
2006,COL,Colombia,65159,114939,1308577,144225,298,0,1633198
2006,COM,Comoros,773,128,85,21,0,0,1007
2006,CPV,Cape Verde,0,0,0,0,0,0,0
2006,CRI,Costa Rica,10129,4615,1137,128,43,0,16052
2006,CUB,Cuba,232406,54089,40265,3405,107,0,330272
2006,CYM,Cayman Islands,0,0,0,0,0,0,0
2006,CYP,Cyprus,0,0,0,0,0,0,0
2006,CZE,Czech Republic,150,0,0,0,0,0,150
2006,DEU,Germany,2574,128,21,0,1222,0,3945
2006,DJI,Djibouti,0,0,0,0,0,0,0
2006,DMA,Dominica,0,0,0,0,0,0,0
2006,DNK,Denmark,15906,128,85,42,21,0,16182
2006,DOM,Dominican Republic,9502,1392,662,1178,42,0,12776
2006,DZA,Algeria,7015,30244,11764,1523,106,2400,53052
2006,ECU,Ecuador,8456,6843,6053,1136,0,0,22488
2006,EGY,Egypt,63776,0,0,193,1309,0,65278
2006,ERI,Eritrea,16357,107,5667,64,0,42,22237
2006,ESH,Western Sahara,0,0,0,0,0,0,0
2006,ESP,Spain,35501,84424,23697,535,236,42,144435
2006,EST,Estonia,835,707,429,1051,107,0,3129
2006,ETH,Ethiopia,523940,3450532,1424707,33459,149,9121,5441908
2006,FIN,Finland,4487,4099,215,256,192,64,9313
2006,FJI,Fiji,107,64,0,0,0,0,171
2006,FRA,France,26917,1349,1155,21,385,21,29848
2006,FRO,Faroe Islands,0,0,0,0,0,0,0
2006,FSM,Micronesia,0,0,0,0,0,0,0
2006,GAB,Gabon,29664,141673,256108,514,0,0,427959
2006,GBR,United Kingdom,4013,279,665,623,86,0,5666
2006,GEO,Georgia,30007,1717,429,0,0,0,32153
2006,GGY,Guernsey,0,0,0,0,0,0,0
2006,GHA,Ghana,1423102,4182257,1678868,32432,1006,193,7317858
2006,GIN,Guinea,661276,3329720,540662,30199,468,64,4562389
2006,GLP,Guadeloupe,0,0,0,0,0,0,0
2006,GMB,Gambia,254349,52845,55232,12341,21,235,375023
2006,GNB,Guinea-Bissau,57053,592073,12620,35268,0,107,697121
2006,GNQ,Equatorial Guinea,21,64,0,0,0,0,85
2006,GRC,Greece,20261,3519,10992,192,43,192,35199
2006,GRD,Grenada,0,0,0,0,0,0,0
2006,GRL,Greenland,0,0,0,0,0,0,0
2006,GTM,Guatemala,151613,64435,10881,686,214,150,227979
2006,GUF,French Guiana,43,687,21,279,43,0,1073
2006,GUM,Guam,0,0,0,0,0,0,0
2006,GUY,Guyana,13951,10133,26230,1116,171,0,51601
2006,HKG,Hong Kong,752,644,107,0,0,0,1503
2006,HND,Honduras,59217,119861,71824,1759,84,21,252766
2006,HRV,Croatia,3092,493,1481,42,0,0,5108
2006,HTI,Haiti,1223,408,1394,537,0,0,3562
2006,HUN,Hungary,23291,2726,1116,85,964,0,28182
2006,IDN,Indonesia,2066690,724038,261961,33772,4181,0,3090642
2006,IMN,Isle of Man,0,0,0,0,0,0,0
2006,IND,India,2162876,713434,152232,6430,11783,107,3046862
2006,IRL,Ireland,0,21,64,600,0,0,685
2006,IRN,Iran,224789,256,9887,5127,1563,92662,334284
2006,IRQ,Iraq,29384,0,4629,449,105,34768,69335
2006,ISL,Iceland,0,0,709,1052,0,0,1761
2006,ISR,Israel,3326,106,0,0,0,85,3517
2006,ITA,Italy,47374,706,2896,21,319,148,51464
2006,JAM,Jamaica,3477,277,406,0,43,0,4203
2006,JEY,Jersey,0,0,0,0,0,0,0
2006,JOR,Jordan,0,0,0,0,0,0,0
2006,JPN,Japan,8779,3263,1910,236,63,0,14251
2006,KAZ,Kazakhstan,3219406,30541,10798682,84394,361,116578,14249962
2006,KEN,Kenya,40414,25580,27796,1585,21,1115,96511
2006,KGZ,Kyrgyzstan,15992,2875,27991,43,0,836,47737
2006,KHM,Cambodia,712704,2267049,61058,9484,0,0,3050295
2006,KNA,Saint Kitts and Nevis,0,0,0,0,0,0,0
2006,KOR,South Korea,257,1394,0,0,0,0,1651
2006,KWT,Kuwait,0,0,0,0,0,1887,1887
2006,LAO,Laos,102509,211115,103762,1904,0,0,419290
2006,LBN,Lebanon,1287,0,278,0,0,0,1565
2006,LBR,Liberia,36983,30954,535,64,0,0,68536
2006,LBY,Libya,86,301,21,0,0,0,408
2006,LCA,Saint Lucia,0,0,0,0,0,0,0
2006,LIE,Liechtenstein,0,0,0,0,0,0,0
2006,LKA,Sri Lanka,36920,2466,1822,257,0,0,41465
2006,LSO,Lesotho,406,2381,44670,0,0,64,47521
2006,LTU,Lithuania,965,214,21,21,0,0,1221
2006,LUX,Luxembourg,0,21,0,0,129,0,150
2006,LVA,Latvia,986,298,214,279,0,0,1777
2006,MAC,Macao,0,0,0,0,0,0,0
2006,MAR,Morocco,3669,5237,363,0,0,85,9354
2006,MDA,Moldova,35927,407,191,42,149,0,36716
2006,MDG,Madagascar,113878,1224048,2735458,32410,320,6780,4112894
2006,MEX,Mexico,445407,809710,217204,7458,1260,2937,1483976
2006,MKD,Macedonia,1631,129,451,21,0,21,2253
2006,MLI,Mali,4236009,752075,3910244,21121,149,64,8919662
2006,MLT,Malta,0,0,0,0,0,0,0
2006,MMR,Myanmar,819694,1812127,301246,8667,86,0,2941820
2006,MNE,Montenegro,1374,816,43,0,0,0,2233
2006,MNG,Mongolia,425278,66866,744649,5858,21,2768,1245440
2006,MNP,Northern Mariana Islands,0,0,0,0,0,0,0
2006,MOZ,Mozambique,1749359,12313420,5218524,566589,255,111449,19959596
2006,MRT,Mauritania,138731,4679,182844,2618,0,1503,330375
2006,MSR,Montserrat,0,0,0,0,0,0,0
2006,MTQ,Martinique,0,0,0,0,0,0,0
2006,MUS,Mauritius,1890,107,0,0,0,0,1997
2006,MWI,Malawi,179885,178331,79826,22319,42,342,460745
2006,MYS,Malaysia,12469,8627,64,192,0,0,21352
2006,MYT,Mayotte,0,0,0,0,0,0,0
2006,NAM,Namibia,277274,1522876,3348721,34431,425,25561,5209288
2006,NCL,New Caledonia,2834,666,1760,64,0,0,5324
2006,NER,Niger,58041,21,114950,7512,0,129,180653
2006,NGA,Nigeria,5583336,2637961,2328527,164192,1538,558,10716112
2006,NIC,Nicaragua,37453,65127,18738,4293,85,0,125696
2006,NLD,Netherlands,623,0,0,0,0,0,623
2006,NOR,Norway,451,556,944,171,21,43,2186
2006,NPL,Nepal,17279,68734,5001,0,0,21,91035
2006,NRU,Nauru,0,0,0,0,0,0,0
2006,NZL,New Zealand,1953,86,1459,0,21,64,3583
2006,OMN,Oman,0,0,0,0,0,0,0
2006,PAK,Pakistan,96937,5279,7272,1738,42,427,111695
2006,PAN,Panama,32712,9142,2531,84,21,64,44554
2006,PER,Peru,19207,44988,12914,405,43,876,78433
2006,PHL,Philippines,80831,4907,4846,1435,43,0,92062
2006,PLW,Palau,0,0,0,0,0,0,0
2006,PNG,Papua New Guinea,246317,61169,99126,7618,707,0,414937
2006,POL,Poland,7165,105,64,0,0,0,7334
2006,PRI,Puerto Rico,107,64,1117,0,0,0,1288
2006,PRK,North Korea,6092,16657,470,213,0,43,23475
2006,PRT,Portugal,21420,44863,3370,107,193,21,69974
2006,PRY,Paraguay,547423,1029347,501887,522988,191,0,2601836
2006,PSE,Palestina,21,0,21,0,0,0,42
2006,PYF,French Polynesia,0,0,0,0,0,0,0
2006,QAT,Qatar,0,0,43,0,86,322,451
2006,REU,Reunion,0,0,0,0,0,0,0
2006,ROU,Romania,207244,5918,2506,2421,856,0,218945
2006,RUS,Russia,6479227,4500954,3199160,246153,18335,83107,14526936
2006,RWA,Rwanda,1459,2318,9616,3091,0,0,16484
2006,SAU,Saudi Arabia,56625,129,407,0,301,18544,76006
2006,SDN,Sudan,2238351,1281380,4677129,53875,964,515,8252214
2006,SEN,Senegal,1049166,2061642,2804408,11525,43,63,5926847
2006,SGP,Singapore,0,0,0,0,0,0,0
2006,SHN,Saint Helena,0,0,0,0,0,0,0
2006,SJM,Svalbard and Jan Mayen,0,0,0,0,0,0,0
2006,SLB,Solomon Islands,0,0,0,0,0,0,0
2006,SLE,Sierra Leone,978544,591555,47287,9746,599,0,1627731
2006,SLV,El Salvador,2144,4333,21,42,21,0,6561
2006,SMR,San Marino,0,0,0,0,0,0,0
2006,SOM,Somalia,3565,300,3241,279,64,43,7492
2006,SPM,Saint Pierre and Miquelon,0,0,0,0,0,0,0
2006,SRB,Serbia,35953,1007,3475,0,322,0,40757
2006,SSD,South Sudan,662416,10940057,12949759,1008292,234,86,25560844
2006,STP,São Tomé and Príncipe,0,0,0,21,0,0,21
2006,SUR,Suriname,730,5409,20285,299,21,0,26744
2006,SVK,Slovakia,85,0,43,0,43,0,171
2006,SVN,Slovenia,128,300,0,0,0,0,428
2006,SWE,Sweden,236,2683,279,473,0,0,3671
2006,SWZ,Swaziland,11764,6846,18417,21,42,429,37519
2006,SYC,Seychelles,0,0,0,0,0,0,0
2006,SYR,Syria,8649,64,0,86,192,901,9892
2006,TCA,Turks and Caicos Islands,0,0,0,0,0,0,0
2006,TCD,Chad,3206499,1710093,6535237,163413,2146,2168,11619556
2006,TGO,Togo,622274,451620,215812,879,64,0,1290649
2006,THA,Thailand,742108,290889,62594,3142,84,0,1098817
2006,TJK,Tajikistan,4551,21,3004,107,0,469,8152
2006,TKL,Tokelau,0,0,0,0,0,0,0
2006,TKM,Turkmenistan,39345,64,31745,385,0,4250,75789
2006,TLS,Timor-Leste,20693,2228,128,64,21,0,23134
2006,TON,Tonga,0,0,0,0,0,0,0
2006,TTO,Trinidad and Tobago,1158,21,0,0,0,0,1179
2006,TUN,Tunisia,236,107,43,0,0,85,471
2006,TUR,Turkey,563799,8344,9355,1564,704,1432,585198
2006,TUV,Tuvalu,0,0,0,0,0,0,0
2006,TWN,Taiwan,0,0,0,0,0,0,0
2006,TZA,Tanzania,730244,7078309,2298623,1154082,235,4138,11265631
2006,UGA,Uganda,362277,368601,274300,19699,107,0,1024984
2006,UKR,Ukraine,1682750,27444,21542,4069,12458,191,1748454
2006,UMI,United States Minor Outlying Islands,0,0,0,0,0,0,0
2006,URY,Uruguay,15774,2890,4761,2165,0,0,25590
2006,USA,United States,845657,837570,1987871,73486,1451,22505,3768540
2006,UZB,Uzbekistan,36041,21,7425,3733,0,791,48011
2006,VCT,Saint Vincent and the Grenadines,0,0,0,0,0,0,0
2006,VEN,Venezuela,331707,230773,1769644,320630,879,21,2653654
2006,VGB,British Virgin Islands,0,0,0,0,0,0,0
2006,VIR,"Virgin Islands, U.S.",0,0,0,0,0,0,0
2006,VNM,Vietnam,285337,190023,46915,1539,213,21,524048
2006,VUT,Vanuatu,0,0,0,0,0,0,0
2006,WLF,Wallis and Futuna,0,0,0,0,0,0,0
2006,WSM,Samoa,0,0,0,0,0,0,0
2006,XAD,Akrotiri and Dhekelia,0,0,0,0,0,0,0
2006,XKO,Kosovo,0,215,0,0,0,0,215
2006,XNC,Northern Cyprus,0,0,0,0,0,0,0
2006,YEM,Yemen,0,0,0,43,0,0,43
2006,ZAF,South Africa,581721,275680,2970830,25005,8261,5725,3867222
2006,ZMB,Zambia,3314756,13941889,4253976,675654,1262,0,22187537
2006,ZWE,Zimbabwe,635024,893706,1585621,6907,169,471,3121898
2007,AFG,Afghanistan,1971,0,7019,0,0,2961,11951
2007,AGO,Angola,1076807,22007187,16109335,95439,2291,2228,39293287
2007,ALA,Åland,0,0,0,0,0,0,0
2007,ALB,Albania,48601,52376,9979,450,0,1115,112521
2007,AND,Andorra,0,0,0,0,0,0,0
2007,ARE,United Arab Emirates,0,0,0,0,0,21,21
2007,ARG,Argentina,1429444,793781,1072985,505855,1862,2981,3806908
2007,ARM,Armenia,792,299,129,0,0,21,1241
2007,ASM,American Samoa,0,0,0,0,0,0,0
2007,ATF,French Southern Territories,0,0,0,0,0,0,0
2007,ATG,Antigua and Barbuda,0,0,0,0,0,0,0
2007,AUS,Australia,136650,4282548,46968156,207682,706,39966,51635708
2007,AUT,Austria,0,21,0,0,0,0,21
2007,AZE,Azerbaijan,108487,1629,18759,43,0,236,129154
2007,BDI,Burundi,3110,7273,14019,214,0,0,24616
2007,BEL,Belgium,601,64,258,0,43,0,966
2007,BEN,Benin,468748,932605,1182338,534,213,43,2584481
2007,BES,"Bonaire, Sint Eustatius and Saba",0,0,0,0,0,0,0
2007,BFA,Burkina Faso,1442973,291765,1359236,4013,21,0,3098008
2007,BGD,Bangladesh,6310,19254,20821,149,0,0,46534
2007,BGR,Bulgaria,94355,14272,1519,598,149,64,110957
2007,BHR,Bahrain,0,0,0,0,0,0,0
2007,BHS,Bahamas,428,13523,2060,494,64,0,16569
2007,BIH,Bosnia and Herzegovina,7878,16485,22411,107,0,0,46881
2007,BLR,Belarus,17130,1759,1050,193,215,0,20347
2007,BLZ,Belize,6417,37047,10623,3283,42,0,57412
2007,BMU,Bermuda,0,0,0,0,0,0,0
2007,BOL,Bolivia,597052,2404690,1232392,631074,407,406,4866021
2007,BRA,Brazil,8332056,8522795,18186949,1408619,15353,4697,36470469
2007,BRB,Barbados,0,0,0,0,0,0,0
2007,BRN,Brunei,0,42,0,21,0,0,63
2007,BTN,Bhutan,1071,15025,751,0,0,0,16847
2007,BWA,Botswana,104515,154913,2451427,114222,0,4594,2829671
2007,CAF,Central African Republic,328215,19057050,3399829,11973,191,85,22797343
2007,CAN,Canada,93180,901885,278686,83800,106,20303,1377960
2007,CHE,Switzerland,0,43,64,0,0,0,107
2007,CHL,Chile,12962,33420,23158,64,86,235,69925
2007,CHN,China,3327413,371434,162911,75574,46833,2701,3986866
2007,CIV,Côte d'Ivoire,732756,2391576,403192,4420,771,0,3532715
2007,CMR,Cameroon,532161,3112117,749714,63386,555,64,4457997
2007,COD,Democratic Republic of the Congo,2828210,24783091,3444536,1400359,5226,235,32461657
2007,COG,Republic of Congo,397093,1736607,1168985,12939,85,0,3315709
2007,COL,Colombia,203936,441695,2791734,259902,427,0,3697694
2007,COM,Comoros,214,300,0,0,0,0,514
2007,CPV,Cape Verde,0,0,0,0,0,0,0
2007,CRI,Costa Rica,15176,15217,579,278,43,0,31293
2007,CUB,Cuba,162323,28719,31569,2203,0,21,224835
2007,CYM,Cayman Islands,0,0,0,0,0,0,0
2007,CYP,Cyprus,429,1460,708,0,0,0,2597
2007,CZE,Czech Republic,2358,21,42,0,0,0,2421
2007,DEU,Germany,150,515,0,0,0,0,665
2007,DJI,Djibouti,0,0,0,0,0,0,0
2007,DMA,Dominica,0,0,0,0,0,0,0
2007,DNK,Denmark,901,21,300,0,0,0,1222
2007,DOM,Dominican Republic,22860,2702,2058,815,21,0,28456
2007,DZA,Algeria,41209,132035,23824,728,21,5642,203459
2007,ECU,Ecuador,14253,8973,5171,1566,0,0,29963
2007,EGY,Egypt,68303,0,0,257,1974,0,70534
2007,ERI,Eritrea,46645,471,36215,106,214,3326,86977
2007,ESH,Western Sahara,0,0,0,0,0,0,0
2007,ESP,Spain,33635,25693,22343,772,0,2210,84653
2007,EST,Estonia,0,0,0,0,0,0,0
2007,ETH,Ethiopia,462890,4072397,2675718,27494,149,10324,7248972
2007,FIN,Finland,1051,215,0,21,0,0,1287
2007,FJI,Fiji,2060,172,193,21,0,0,2446
2007,FRA,France,9979,1631,1115,300,0,0,13025
2007,FRO,Faroe Islands,0,0,0,0,0,0,0
2007,FSM,Micronesia,0,0,0,0,0,0,0
2007,GAB,Gabon,18095,138388,233570,43,0,0,390096
2007,GBR,United Kingdom,0,256,10797,2725,0,172,13950
2007,GEO,Georgia,10368,344,901,0,0,0,11613
2007,GGY,Guernsey,0,0,0,0,0,0,0
2007,GHA,Ghana,1187897,3552429,1565590,33353,426,256,6339951
2007,GIN,Guinea,916955,2822740,430198,32194,426,43,4202556
2007,GLP,Guadeloupe,0,0,0,0,0,0,0
2007,GMB,Gambia,232712,43316,36405,12471,0,386,325290
2007,GNB,Guinea-Bissau,56132,524792,9204,27429,0,171,617728
2007,GNQ,Equatorial Guinea,0,21,0,0,0,0,21
2007,GRC,Greece,161657,72019,76631,944,300,2444,313995
2007,GRD,Grenada,0,0,0,43,0,0,43
2007,GRL,Greenland,0,0,0,0,0,0,0
2007,GTM,Guatemala,362108,141327,39387,1499,127,493,544941
2007,GUF,French Guiana,42,257,235,257,128,0,919
2007,GUM,Guam,0,0,0,0,0,0,0
2007,GUY,Guyana,8542,14229,32928,2254,493,0,58446
2007,HKG,Hong Kong,193,43,21,0,0,0,257
2007,HND,Honduras,40030,77166,51064,1650,255,0,170165
2007,HRV,Croatia,6136,7833,10775,236,236,150,25366
2007,HTI,Haiti,988,171,599,601,0,0,2359
2007,HUN,Hungary,24875,1929,2722,0,730,0,30256
2007,IDN,Indonesia,226783,54040,52502,2872,3712,0,339909
2007,IMN,Isle of Man,0,0,0,0,0,0,0
2007,IND,India,2391682,1231861,147311,5465,13497,664,3790480
2007,IRL,Ireland,0,192,558,2638,0,0,3388
2007,IRN,Iran,338189,514,18627,7597,1027,77957,443911
2007,IRQ,Iraq,73429,149,8621,963,85,18518,101765
2007,ISL,Iceland,0,0,0,0,0,0,0
2007,ISR,Israel,299,43,1331,107,0,236,2016
2007,ITA,Italy,163801,31571,33097,470,726,899,230564
2007,JAM,Jamaica,1137,279,86,0,0,0,1502
2007,JEY,Jersey,0,0,0,0,0,0,0
2007,JOR,Jordan,0,0,0,0,0,43,43
2007,JPN,Japan,6461,5065,2748,106,0,0,14380
2007,KAZ,Kazakhstan,2459907,54004,5371088,33354,2616,187716,8108685
2007,KEN,Kenya,267959,124345,352331,18024,0,3947,766606
2007,KGZ,Kyrgyzstan,19600,1586,20841,0,107,42,42176
2007,KHM,Cambodia,1042979,2153458,71368,15086,0,129,3283020
2007,KNA,Saint Kitts and Nevis,0,0,0,0,0,0,0
2007,KOR,South Korea,665,3907,86,0,0,0,4658
2007,KWT,Kuwait,0,0,0,0,0,214,214
2007,LAO,Laos,287578,810242,529756,4867,0,0,1632443
2007,LBN,Lebanon,493,21,708,0,0,21,1243
2007,LBR,Liberia,28398,5408,449,171,21,0,34447
2007,LBY,Libya,0,0,21,0,0,408,429
2007,LCA,Saint Lucia,0,0,0,0,0,0,0
2007,LIE,Liechtenstein,0,0,0,0,0,0,0
2007,LKA,Sri Lanka,39498,748,2465,321,0,0,43032
2007,LSO,Lesotho,6052,7252,111300,0,43,0,124647
2007,LTU,Lithuania,1201,21,21,21,0,0,1264
2007,LUX,Luxembourg,0,0,0,0,0,0,0
2007,LVA,Latvia,408,816,279,0,0,0,1503
2007,MAC,Macao,0,0,0,0,0,0,0
2007,MAR,Morocco,815,1331,21,0,0,0,2167
2007,MDA,Moldova,33566,1285,127,64,128,0,35170
2007,MDG,Madagascar,140625,1625416,4121811,30269,641,13159,5931921
2007,MEX,Mexico,516060,760940,270335,16369,1195,3325,1568224
2007,MKD,Macedonia,13363,21031,10944,64,21,21,45444
2007,MLI,Mali,4245713,598233,3110208,22281,64,3477,7979976
2007,MLT,Malta,0,0,0,0,0,0,0
2007,MMR,Myanmar,996119,3211721,869320,13476,0,0,5090636
2007,MNE,Montenegro,9268,17793,4786,64,0,64,31975
2007,MNG,Mongolia,589515,141396,1046718,11269,0,3454,1792352
2007,MNP,Northern Mariana Islands,0,0,0,0,0,0,0
2007,MOZ,Mozambique,2022104,12580865,5726644,575791,320,116877,21022601
2007,MRT,Mauritania,364597,3693,485709,2726,0,1351,858076
2007,MSR,Montserrat,0,0,0,0,0,0,0
2007,MTQ,Martinique,0,0,0,0,0,0,0
2007,MUS,Mauritius,0,0,0,0,0,0,0
2007,MWI,Malawi,206305,226049,107230,21224,85,579,561472
2007,MYS,Malaysia,32370,7682,621,385,64,0,41122
2007,MYT,Mayotte,0,0,0,0,0,0,0
2007,NAM,Namibia,233505,641480,3635090,19832,448,4850,4535205
2007,NCL,New Caledonia,0,0,0,0,0,0,0
2007,NER,Niger,110398,386,201241,10990,0,1008,324023
2007,NGA,Nigeria,5570737,2301286,2158839,133464,2164,235,10166725
2007,NIC,Nicaragua,36982,40907,35543,5922,148,0,119502
2007,NLD,Netherlands,365,21,21,0,0,0,407
2007,NOR,Norway,172,1932,623,43,0,0,2770
2007,NPL,Nepal,10108,53319,2274,321,0,0,66022
2007,NRU,Nauru,0,0,0,0,0,0,0
2007,NZL,New Zealand,150,64,3326,192,149,85,3966
2007,OMN,Oman,0,0,0,0,0,365,365
2007,PAK,Pakistan,109729,11610,4547,1864,21,169,127940
2007,PAN,Panama,15950,2661,1823,256,21,43,20754
2007,PER,Peru,29165,75127,15216,1437,106,298,121349
2007,PHL,Philippines,113375,7913,7531,383,85,0,129287
2007,PLW,Palau,0,0,0,0,0,0,0
2007,PNG,Papua New Guinea,115401,7052,14421,3389,965,0,141228
2007,POL,Poland,4787,43,21,0,42,0,4893
2007,PRI,Puerto Rico,343,64,2426,0,0,0,2833
2007,PRK,North Korea,3971,13991,687,107,0,64,18820
2007,PRT,Portugal,3904,10861,1866,0,21,0,16652
2007,PRY,Paraguay,842955,1570731,929976,573457,191,43,3917353
2007,PSE,Palestina,0,0,64,43,0,0,107
2007,PYF,French Polynesia,0,0,0,0,0,0,0
2007,QAT,Qatar,0,0,21,0,21,257,299
2007,REU,Reunion,0,0,0,0,0,0,0
2007,ROU,Romania,104643,3127,4287,25843,300,0,138200
2007,RUS,Russia,5436458,3001888,2343550,170775,17744,41267,11011682
2007,RWA,Rwanda,1546,879,3111,301,0,0,5837
2007,SAU,Saudi Arabia,59459,0,321,0,0,14724,74504
2007,SDN,Sudan,3371197,1616852,5662968,82317,706,18480,10752520
2007,SEN,Senegal,754354,1343353,2049452,11005,107,0,4158271
2007,SGP,Singapore,0,0,0,0,0,0,0
2007,SHN,Saint Helena,0,0,0,0,0,0,0
2007,SJM,Svalbard and Jan Mayen,0,0,0,0,0,0,0
2007,SLB,Solomon Islands,0,0,0,0,0,0,0
2007,SLE,Sierra Leone,706743,685450,35697,5474,299,0,1433663
2007,SLV,El Salvador,2724,965,0,106,0,0,3795
2007,SMR,San Marino,0,0,0,0,0,0,0
2007,SOM,Somalia,10022,8263,19445,128,0,0,37858
2007,SPM,Saint Pierre and Miquelon,0,0,0,0,0,0,0
2007,SRB,Serbia,39773,15859,6675,169,21,21,62518
2007,SSD,South Sudan,834465,14285932,17005842,1053454,233,472,33180398
2007,STP,São Tomé and Príncipe,0,21,0,21,0,0,42
2007,SUR,Suriname,493,1630,965,64,0,0,3152
2007,SVK,Slovakia,1049,279,21,0,0,0,1349
2007,SVN,Slovenia,0,43,0,0,0,0,43
2007,SWE,Sweden,279,0,21,0,0,0,300
2007,SWZ,Swaziland,33481,60706,51045,877,42,1889,148040
2007,SYC,Seychelles,0,0,0,0,0,0,0
2007,SYR,Syria,11354,2705,128,214,21,15604,30026
2007,TCA,Turks and Caicos Islands,0,0,0,0,0,0,0
2007,TCD,Chad,3282391,1843031,6970560,142015,1865,262763,12502625
2007,TGO,Togo,280149,352618,182822,385,0,0,815974
2007,THA,Thailand,1218304,840181,170530,8530,148,0,2237693
2007,TJK,Tajikistan,3306,0,2812,0,0,3692,9810
2007,TKL,Tokelau,0,0,0,0,0,0,0
2007,TKM,Turkmenistan,47588,150,112801,643,0,30780,191962
2007,TLS,Timor-Leste,10710,900,0,0,64,0,11674
2007,TON,Tonga,0,0,0,0,0,0,0
2007,TTO,Trinidad and Tobago,1244,558,43,0,0,0,1845
2007,TUN,Tunisia,687,707,107,0,0,601,2102
2007,TUR,Turkey,392875,7013,6172,2444,1071,1152,410727
2007,TUV,Tuvalu,0,0,0,0,0,0,0
2007,TWN,Taiwan,0,0,0,0,0,0,0
2007,TZA,Tanzania,1550585,8086165,4045215,1301339,724,3683,14987711
2007,UGA,Uganda,597341,2271108,1582778,10870,85,0,4462182
2007,UKR,Ukraine,2305217,31179,46457,10792,24995,127,2418767
2007,UMI,United States Minor Outlying Islands,0,0,0,0,0,0,0
2007,URY,Uruguay,10061,3576,8278,1026,85,0,23026
2007,USA,United States,989229,1390207,1570911,87029,4071,33859,4075306
2007,UZB,Uzbekistan,23482,150,10216,429,43,1566,35886
2007,VCT,Saint Vincent and the Grenadines,0,0,0,0,0,0,0
2007,VEN,Venezuela,378481,289201,2014202,304873,514,0,2987271
2007,VGB,British Virgin Islands,0,0,0,0,0,0,0
2007,VIR,"Virgin Islands, U.S.",0,0,0,0,0,0,0
2007,VNM,Vietnam,507721,403526,174805,2719,170,0,1088941
2007,VUT,Vanuatu,0,0,0,0,0,0,0
2007,WLF,Wallis and Futuna,0,0,0,0,0,0,0
2007,WSM,Samoa,0,0,0,0,0,0,0
2007,XAD,Akrotiri and Dhekelia,0,0,0,0,0,0,0
2007,XKO,Kosovo,8801,10773,1330,0,21,43,20968
2007,XNC,Northern Cyprus,0,0,0,0,0,0,0
2007,YEM,Yemen,0,0,0,0,0,21,21
2007,ZAF,South Africa,665034,369791,3080028,18480,2979,6435,4142747
2007,ZMB,Zambia,3529220,15180104,4625442,542268,1348,107,23878489
2007,ZWE,Zimbabwe,866659,1212564,1841255,11096,449,1844,3933867
2008,AFG,Afghanistan,22836,0,48511,708,0,3585,75640
2008,AGO,Angola,1002212,21646633,13857567,113140,2504,2143,36624199
2008,ALA,Åland,0,0,0,0,0,0,0
2008,ALB,Albania,13138,751,664,0,0,0,14553
2008,AND,Andorra,0,0,0,0,0,0,0
2008,ARE,United Arab Emirates,0,0,0,0,43,21,64
2008,ARG,Argentina,1479876,854959,1260558,1515846,2011,5084,5118334
2008,ARM,Armenia,7985,278,4377,0,0,0,12640
2008,ASM,American Samoa,0,0,0,0,0,0,0
2008,ATF,French Southern Territories,0,0,0,0,0,0,0
2008,ATG,Antigua and Barbuda,0,0,0,0,0,0,0
2008,AUS,Australia,206585,3824550,27560545,113917,533,11483,31717613
2008,AUT,Austria,2640,107,0,0,85,0,2832
2008,AZE,Azerbaijan,80858,2382,6113,107,0,128,89588
2008,BDI,Burundi,10299,11821,21399,148,21,0,43688
2008,BEL,Belgium,0,0,0,0,0,0,0
2008,BEN,Benin,311835,590414,952825,256,213,0,1855543
2008,BES,"Bonaire, Sint Eustatius and Saba",0,0,0,0,0,0,0
2008,BFA,Burkina Faso,1260155,257844,1033194,1604,21,21,2552839
2008,BGD,Bangladesh,10798,41515,39625,451,0,0,92389
2008,BGR,Bulgaria,87895,3429,298,471,128,64,92285
2008,BHR,Bahrain,0,0,0,0,0,0,0
2008,BHS,Bahamas,944,40034,901,2618,0,0,44497
2008,BIH,Bosnia and Herzegovina,5689,5967,8049,107,0,0,19812
2008,BLR,Belarus,36620,2789,2208,0,21,0,41638
2008,BLZ,Belize,7534,21293,6678,793,0,0,36298
2008,BMU,Bermuda,0,0,0,0,0,0,0
2008,BOL,Bolivia,473793,1344855,889735,502191,106,364,3211044
2008,BRA,Brazil,4315446,2768827,7213627,942407,9517,3517,15253341
2008,BRB,Barbados,0,0,0,0,0,0,0
2008,BRN,Brunei,0,0,0,0,0,0,0
2008,BTN,Bhutan,406,2874,149,0,0,0,3429
2008,BWA,Botswana,411199,601408,9988449,12253,21,3778,11017108
2008,CAF,Central African Republic,422189,21210803,3631681,12680,255,86,25277694
2008,CAN,Canada,170266,1045151,160323,114690,86,4331,1494847
2008,CHE,Switzerland,0,0,0,0,0,0,0
2008,CHL,Chile,15106,41830,28609,471,107,493,86616
2008,CHN,China,1774110,957598,260247,131296,12960,2638,3138849
2008,CIV,Côte d'Ivoire,453654,2093200,341237,1070,553,0,2889714
2008,CMR,Cameroon,604797,3525232,714379,60486,428,64,4905386
2008,COD,Democratic Republic of the Congo,3034895,26619455,3490063,1585096,6064,214,34735787
2008,COG,Republic of Congo,402051,1615415,1172233,24148,64,21,3213932
2008,COL,Colombia,65485,176204,2181187,233799,63,43,2656781
2008,COM,Comoros,1825,944,149,0,0,0,2918
2008,CPV,Cape Verde,0,0,0,0,0,0,0
2008,CRI,Costa Rica,14961,3111,128,149,43,0,18392
2008,CUB,Cuba,132805,19379,32925,5851,63,0,191023
2008,CYM,Cayman Islands,0,0,0,0,0,0,0
2008,CYP,Cyprus,429,945,301,0,0,43,1718
2008,CZE,Czech Republic,515,42,0,86,0,0,643
2008,DEU,Germany,13953,106,86,0,149,0,14294
2008,DJI,Djibouti,0,0,0,0,0,0,0
2008,DMA,Dominica,0,0,0,0,0,0,0
2008,DNK,Denmark,3220,0,0,0,21,0,3241
2008,DOM,Dominican Republic,19853,3711,1734,3112,64,0,28474
2008,DZA,Algeria,20262,71520,5880,321,0,1522,99505
2008,ECU,Ecuador,2188,514,685,86,0,0,3473
2008,EGY,Egypt,29406,0,0,107,792,0,30305
2008,ERI,Eritrea,50145,278,19919,85,42,0,70469
2008,ESH,Western Sahara,0,0,0,0,0,0,0
2008,ESP,Spain,14895,12428,6072,150,0,42,33587
2008,EST,Estonia,43,0,0,687,0,0,730
2008,ETH,Ethiopia,472287,3347965,1725016,36424,837,26057,5608586
2008,FIN,Finland,3520,1202,0,0,0,0,4722
2008,FJI,Fiji,1052,344,0,64,0,0,1460
2008,FRA,France,37969,4957,10216,42,214,0,53398
2008,FRO,Faroe Islands,0,0,0,0,0,0,0
2008,FSM,Micronesia,0,0,0,0,0,0,0
2008,GAB,Gabon,45978,159855,277488,450,0,0,483771
2008,GBR,United Kingdom,0,0,0,0,0,0,0
2008,GEO,Georgia,8457,1761,795,0,0,0,11013
2008,GGY,Guernsey,0,0,0,0,0,0,0
2008,GHA,Ghana,1473631,3434557,1364819,19577,749,191,6293524
2008,GIN,Guinea,361679,3480902,583957,15882,254,21,4442695
2008,GLP,Guadeloupe,0,0,0,0,0,0,0
2008,GMB,Gambia,180399,34840,42073,5429,21,128,262890
2008,GNB,Guinea-Bissau,23028,323571,8026,9439,0,43,364107
2008,GNQ,Equatorial Guinea,0,42,0,0,0,0,42
2008,GRC,Greece,88072,11546,13178,214,170,427,113607
2008,GRD,Grenada,0,0,0,0,0,0,0
2008,GRL,Greenland,0,0,0,0,0,0,0
2008,GTM,Guatemala,149012,68022,23203,922,105,0,241264
2008,GUF,French Guiana,365,2661,1180,1224,515,0,5945
2008,GUM,Guam,0,0,0,0,0,0,0
2008,GUY,Guyana,12705,9248,16655,1758,534,0,40900
2008,HKG,Hong Kong,859,494,86,42,0,0,1481
2008,HND,Honduras,47566,102755,56861,2275,127,0,209584
2008,HRV,Croatia,9400,3946,2232,85,0,0,15663
2008,HTI,Haiti,1114,43,3089,193,0,0,4439
2008,HUN,Hungary,16528,127,386,0,21,0,17062
2008,IDN,Indonesia,146781,32107,43165,2184,4915,0,229152
2008,IMN,Isle of Man,0,0,0,0,0,0,0
2008,IND,India,2406364,885188,128957,6409,12082,63,3439063
2008,IRL,Ireland,0,0,0,0,0,0,0
2008,IRN,Iran,117930,2232,24487,6780,406,128748,280583
2008,IRQ,Iraq,97021,2917,22318,2895,64,28826,154041
2008,ISL,Iceland,0,0,0,0,0,0,0
2008,ISR,Israel,258,0,0,21,64,64,407
2008,ITA,Italy,115955,4485,9721,107,170,213,130651
2008,JAM,Jamaica,43,21,43,0,0,0,107
2008,JEY,Jersey,0,0,0,0,0,0,0
2008,JOR,Jordan,0,0,0,0,0,0,0
2008,JPN,Japan,5496,6783,944,21,43,0,13287
2008,KAZ,Kazakhstan,3626791,74590,6247626,61110,3217,29014,10042348
2008,KEN,Kenya,90398,98625,103267,11200,0,2510,306000
2008,KGZ,Kyrgyzstan,4440,1180,11871,0,0,341,17832
2008,KHM,Cambodia,764867,2034354,58232,15576,0,21,2873050
2008,KNA,Saint Kitts and Nevis,0,0,0,0,0,0,0
2008,KOR,South Korea,235,2748,129,0,0,0,3112
2008,KWT,Kuwait,43,0,43,21,0,43,150
2008,LAO,Laos,122866,148113,76372,2163,0,0,349514
2008,LBN,Lebanon,0,0,0,0,0,0,0
2008,LBR,Liberia,13566,10990,193,21,149,0,24919
2008,LBY,Libya,0,0,0,0,0,0,0
2008,LCA,Saint Lucia,0,0,0,0,0,0,0
2008,LIE,Liechtenstein,0,0,0,0,0,0,0
2008,LKA,Sri Lanka,38080,64,943,1137,21,0,40245
2008,LSO,Lesotho,708,599,19640,21,0,21,20989
2008,LTU,Lithuania,3177,493,128,0,0,0,3798
2008,LUX,Luxembourg,0,0,0,0,0,0,0
2008,LVA,Latvia,0,0,0,0,0,0,0
2008,MAC,Macao,0,0,0,0,0,0,0
2008,MAR,Morocco,321,515,0,0,0,0,836
2008,MDA,Moldova,127522,467,170,213,190,0,128562
2008,MDG,Madagascar,90541,894007,2704135,17298,233,9122,3715336
2008,MEX,Mexico,575835,902535,286686,9334,1755,4562,1780707
2008,MKD,Macedonia,3432,3305,2703,0,0,0,9440
2008,MLI,Mali,4395866,777986,3380357,20044,64,857,8575174
2008,MLT,Malta,0,0,0,0,0,0,0
2008,MMR,Myanmar,676003,1520554,320250,8947,21,0,2525775
2008,MNE,Montenegro,1609,3884,300,21,21,0,5835
2008,MNG,Mongolia,248355,201628,376441,14228,21,407,841080
2008,MNP,Northern Mariana Islands,0,0,0,0,0,0,0
2008,MOZ,Mozambique,2024638,14122888,5673730,642531,793,137848,22602428
2008,MRT,Mauritania,131736,2384,240805,4079,21,2554,381579
2008,MSR,Montserrat,0,0,0,0,0,0,0
2008,MTQ,Martinique,0,0,0,0,0,0,0
2008,MUS,Mauritius,0,0,0,0,0,0,0
2008,MWI,Malawi,207033,244894,104681,22042,190,1073,579913
2008,MYS,Malaysia,11805,4011,707,300,258,0,17081
2008,MYT,Mayotte,0,0,0,0,0,0,0
2008,NAM,Namibia,150023,609519,2049238,29557,621,1738,2840696
2008,NCL,New Caledonia,0,0,0,0,0,0,0
2008,NER,Niger,68708,2039,174215,12062,0,1094,258118
2008,NGA,Nigeria,4455254,2601639,1910121,112366,3967,427,9083774
2008,NIC,Nicaragua,48528,65016,83197,10600,64,0,207405
2008,NLD,Netherlands,0,0,0,0,0,0,0
2008,NOR,Norway,1867,2726,322,128,107,0,5150
2008,NPL,Nepal,15455,121068,2168,149,43,0,138883
2008,NRU,Nauru,0,0,0,0,0,0,0
2008,NZL,New Zealand,86,0,601,236,0,0,923
2008,OMN,Oman,0,0,0,0,0,0,0
2008,PAK,Pakistan,128173,2898,8044,15795,84,770,155764
2008,PAN,Panama,18611,6396,2145,235,0,21,27408
2008,PER,Peru,9955,30135,28800,427,170,686,70173
2008,PHL,Philippines,32428,2978,2444,214,0,0,38064
2008,PLW,Palau,0,0,0,0,0,0,0
2008,PNG,Papua New Guinea,137661,7889,12554,5448,471,0,164023
2008,POL,Poland,14341,127,85,107,106,0,14766
2008,PRI,Puerto Rico,364,129,1953,0,0,0,2446
2008,PRK,North Korea,8349,21011,1437,579,0,172,31548
2008,PRT,Portugal,4889,2293,557,107,0,21,7867
2008,PRY,Paraguay,489951,755955,497956,473403,191,42,2217498
2008,PSE,Palestina,86,0,64,0,0,0,150
2008,PYF,French Polynesia,0,0,0,0,0,0,0
2008,QAT,Qatar,0,0,21,0,43,385,449
2008,REU,Reunion,0,0,0,0,0,0,0
2008,ROU,Romania,487808,2635,2998,8797,63,0,502301
2008,RUS,Russia,9711549,9401322,3896690,470700,34156,67837,23582254
2008,RWA,Rwanda,1244,1566,10861,4443,0,0,18114
2008,SAU,Saudi Arabia,13092,64,515,0,0,2252,15923
2008,SDN,Sudan,2578182,1400389,4310521,62628,492,2891,8355103
2008,SEN,Senegal,625063,1453412,2528015,7744,86,0,4614320
2008,SGP,Singapore,0,0,0,0,0,0,0
2008,SHN,Saint Helena,0,0,0,0,0,0,0
2008,SJM,Svalbard and Jan Mayen,0,0,0,0,0,0,0
2008,SLB,Solomon Islands,0,0,0,0,0,0,0
2008,SLE,Sierra Leone,292128,433632,30372,5215,493,0,761840
2008,SLV,El Salvador,2767,428,0,0,0,0,3195
2008,SMR,San Marino,0,0,0,0,0,0,0
2008,SOM,Somalia,12406,6161,9336,622,0,43,28568
2008,SPM,Saint Pierre and Miquelon,0,0,0,0,0,0,0
2008,SRB,Serbia,81071,384,8925,321,85,0,90786
2008,SSD,South Sudan,665203,15465720,14719225,785582,320,21,31636071
2008,STP,São Tomé and Príncipe,0,0,0,0,0,0,0
2008,SUR,Suriname,1073,6654,4379,407,43,0,12556
2008,SVK,Slovakia,579,0,0,21,21,0,621
2008,SVN,Slovenia,0,0,0,0,0,0,0
2008,SWE,Sweden,43,21,0,21,0,0,85
2008,SWZ,Swaziland,25414,41685,43553,1716,129,2489,114986
2008,SYC,Seychelles,0,0,0,0,0,0,0
2008,SYR,Syria,192,86,64,85,0,107,534
2008,TCA,Turks and Caicos Islands,0,0,0,0,0,0,0
2008,TCD,Chad,2957635,1371540,6576561,158992,791,6869,11072388
2008,TGO,Togo,462632,467008,186537,363,148,0,1116688
2008,THA,Thailand,683193,378348,77437,2912,191,0,1142081
2008,TJK,Tajikistan,321,0,64,21,0,64,470
2008,TKL,Tokelau,0,0,0,0,0,0,0
2008,TKM,Turkmenistan,16053,86,10966,1351,0,2489,30945
2008,TLS,Timor-Leste,13414,1091,21,43,21,0,14590
2008,TON,Tonga,0,0,0,0,0,0,0
2008,TTO,Trinidad and Tobago,643,85,21,21,0,0,770
2008,TUN,Tunisia,301,343,214,0,0,21,879
2008,TUR,Turkey,217640,20623,2978,1972,703,961,244877
2008,TUV,Tuvalu,0,0,0,0,0,0,0
2008,TWN,Taiwan,1589,0,64,0,21,0,1674
2008,TZA,Tanzania,1149424,8344446,3440292,1218606,448,4524,14157740
2008,UGA,Uganda,739423,1505382,1036340,10830,107,0,3292082
2008,UKR,Ukraine,4444222,20788,34766,4928,14117,171,4518992
2008,UMI,United States Minor Outlying Islands,0,0,0,0,0,0,0
2008,URY,Uruguay,22037,8065,12525,2698,107,0,45432
2008,USA,United States,767749,834098,1189689,59871,5467,11452,2868326
2008,UZB,Uzbekistan,23762,172,10366,8264,0,1888,44452
2008,VCT,Saint Vincent and the Grenadines,0,0,0,0,0,0,0
2008,VEN,Venezuela,369765,218836,1691419,330313,406,21,2610760
2008,VGB,British Virgin Islands,0,0,0,0,0,0,0
2008,VIR,"Virgin Islands, U.S.",0,0,0,0,0,0,0
2008,VNM,Vietnam,562223,135048,30209,2635,300,0,730415
2008,VUT,Vanuatu,0,0,0,0,0,0,0
2008,WLF,Wallis and Futuna,0,0,0,0,0,0,0
2008,WSM,Samoa,0,0,0,0,0,0,0
2008,XAD,Akrotiri and Dhekelia,0,0,0,0,0,0,0
2008,XKO,Kosovo,192,215,64,0,0,0,471
2008,XNC,Northern Cyprus,0,0,0,0,0,0,0
2008,YEM,Yemen,21,0,0,21,0,0,42
2008,ZAF,South Africa,571936,353588,3254978,19038,5234,4524,4209298
2008,ZMB,Zambia,3448727,15841807,4588393,597241,898,150,24477216
2008,ZWE,Zimbabwe,881063,1402271,2194906,7508,191,2059,4487998
2009,AFG,Afghanistan,3305,0,4850,364,0,1717,10236
2009,AGO,Angola,870869,22076006,13509865,90130,1882,1266,36550018
2009,ALA,Åland,0,0,0,0,0,0,0
2009,ALB,Albania,4400,794,751,64,0,0,6009
2009,AND,Andorra,0,0,0,0,0,0,0
2009,ARE,United Arab Emirates,0,0,0,0,0,0,0
2009,ARG,Argentina,848670,726507,1314818,443866,1498,4052,3339411
2009,ARM,Armenia,1932,0,43,0,773,64,2812
2009,ASM,American Samoa,0,0,0,0,0,0,0
2009,ATF,French Southern Territories,0,0,0,0,0,0,0
2009,ATG,Antigua and Barbuda,0,0,0,0,0,0,0
2009,AUS,Australia,438351,5910991,34360244,212358,856,11138,40933938
2009,AUT,Austria,1374,64,0,0,0,0,1438
2009,AZE,Azerbaijan,83310,386,3173,193,0,107,87169
2009,BDI,Burundi,5170,10581,15324,385,0,0,31460
2009,BEL,Belgium,301,0,21,0,43,0,365
2009,BEN,Benin,338085,732690,814305,707,213,0,1886000
2009,BES,"Bonaire, Sint Eustatius and Saba",0,0,0,0,0,0,0
2009,BFA,Burkina Faso,1486085,264651,1154907,4161,0,43,2909847
2009,BGD,Bangladesh,7556,51883,58172,407,21,0,118039
2009,BGR,Bulgaria,29987,450,385,150,21,0,30993
2009,BHR,Bahrain,0,0,0,0,0,0,0
2009,BHS,Bahamas,192,17194,557,1306,0,0,19249
2009,BIH,Bosnia and Herzegovina,578,923,1224,0,0,0,2725
2009,BLR,Belarus,32477,3477,1910,342,21,0,38227
2009,BLZ,Belize,3561,8219,2960,406,0,0,15146
2009,BMU,Bermuda,0,0,0,0,0,0,0
2009,BOL,Bolivia,293974,706440,720285,399884,213,106,2120902
2009,BRA,Brazil,3330590,1480238,3601836,630894,8897,3087,9055542
2009,BRB,Barbados,0,0,0,0,0,0,0
2009,BRN,Brunei,107,128,0,0,0,0,235
2009,BTN,Bhutan,64,1479,257,0,0,0,1800
2009,BWA,Botswana,149636,288585,1711261,11270,0,8845,2169597
2009,CAF,Central African Republic,210187,13402768,2191724,7634,363,63,15812739
2009,CAN,Canada,84572,472765,97219,16227,127,14038,684948
2009,CHE,Switzerland,0,301,0,0,0,0,301
2009,CHL,Chile,14357,33633,30049,171,106,599,78915
2009,CHN,China,2610262,400635,151519,87791,28154,1222,3279583
2009,CIV,Côte d'Ivoire,256859,1920824,286161,1758,1114,0,2466716
2009,CMR,Cameroon,436956,2997216,616047,62081,812,150,4113262
2009,COD,Democratic Republic of the Congo,2840473,26442054,3429915,1649300,5099,362,34367203
2009,COG,Republic of Congo,321770,1702586,1043968,19466,21,0,3087811
2009,COL,Colombia,77997,121849,1483870,144653,106,0,1828475
2009,COM,Comoros,0,150,171,0,0,0,321
2009,CPV,Cape Verde,0,0,0,0,0,0,0
2009,CRI,Costa Rica,19833,6675,859,170,43,0,27580
2009,CUB,Cuba,233520,57653,47520,4845,127,0,343665
2009,CYM,Cayman Islands,0,0,0,0,0,0,0
2009,CYP,Cyprus,0,0,0,0,0,0,0
2009,CZE,Czech Republic,407,236,0,0,0,0,643
2009,DEU,Germany,235,364,0,0,107,0,706
2009,DJI,Djibouti,0,0,0,0,0,0,0
2009,DMA,Dominica,0,0,0,0,0,0,0
2009,DNK,Denmark,945,0,0,0,0,0,945
2009,DOM,Dominican Republic,11976,2253,2167,792,21,21,17230
2009,DZA,Algeria,37281,43660,48470,105,42,2145,131703
2009,ECU,Ecuador,18500,8839,14956,792,0,21,43108
2009,EGY,Egypt,31770,0,21,21,1073,0,32885
2009,ERI,Eritrea,6977,214,2706,64,21,214,10196
2009,ESH,Western Sahara,0,0,0,0,0,0,0
2009,ESP,Spain,21481,47029,25669,300,21,835,95335
2009,EST,Estonia,43,0,0,0,0,0,43
2009,ETH,Ethiopia,361703,3481330,2318548,36036,278,32606,6230501
2009,FIN,Finland,1652,1266,21,21,21,0,2981
2009,FJI,Fiji,5195,3799,0,85,0,0,9079
2009,FRA,France,13136,6330,7854,234,171,601,28326
2009,FRO,Faroe Islands,0,0,0,0,0,0,0
2009,FSM,Micronesia,0,0,0,0,0,0,0
2009,GAB,Gabon,7405,119972,186946,21,0,0,314344
2009,GBR,United Kingdom,21,64,1631,451,0,0,2167
2009,GEO,Georgia,1352,128,300,0,0,0,1780
2009,GGY,Guernsey,0,0,0,0,0,0,0
2009,GHA,Ghana,962723,3108663,1174353,14228,491,64,5260522
2009,GIN,Guinea,534370,2925582,478087,18933,385,86,3957443
2009,GLP,Guadeloupe,0,0,0,0,0,0,0
2009,GMB,Gambia,221356,39517,35354,7810,21,127,304185
2009,GNB,Guinea-Bissau,27927,350686,9570,15622,0,42,403847
2009,GNQ,Equatorial Guinea,0,0,0,0,0,0,0
2009,GRC,Greece,24684,4829,19728,407,279,1610,51537
2009,GRD,Grenada,0,0,0,0,0,0,0
2009,GRL,Greenland,0,0,0,0,0,0,0
2009,GTM,Guatemala,235607,156867,22946,768,105,21,416314
2009,GUF,French Guiana,172,1007,558,1073,279,0,3089
2009,GUM,Guam,0,0,0,0,0,0,0
2009,GUY,Guyana,18372,21182,27089,2296,472,0,69411
2009,HKG,Hong Kong,193,729,21,21,0,0,964
2009,HND,Honduras,47565,150107,52397,1133,106,0,251308
2009,HRV,Croatia,3134,1932,536,0,0,0,5602
2009,HTI,Haiti,344,0,1759,172,0,0,2275
2009,HUN,Hungary,7145,279,1009,192,215,0,8840
2009,IDN,Indonesia,1206650,455242,146282,12614,2525,0,1823313
2009,IMN,Isle of Man,0,0,0,0,0,0,0
2009,IND,India,3019367,2389190,220060,7868,16696,21,5653202
2009,IRL,Ireland,0,0,0,0,0,0,0
2009,IRN,Iran,142056,1351,16480,4443,405,47455,212190
2009,IRQ,Iraq,49450,1673,31875,3409,42,9268,95717
2009,ISL,Iceland,0,0,0,0,0,0,0
2009,ISR,Israel,2061,150,0,0,0,0,2211
2009,ITA,Italy,43403,2081,9830,86,0,127,55527
2009,JAM,Jamaica,3326,773,0,0,21,0,4120
2009,JEY,Jersey,0,0,0,0,0,0,0
2009,JOR,Jordan,0,0,0,0,0,0,0
2009,JPN,Japan,16162,3026,1953,107,214,0,21462
2009,KAZ,Kazakhstan,1551813,23734,3224085,89337,406,16934,4906309
2009,KEN,Kenya,64673,39322,29168,2874,21,643,136701
2009,KGZ,Kyrgyzstan,6655,0,1717,0,0,320,8692
2009,KHM,Cambodia,716334,2153966,57711,28331,0,64,2956406
2009,KNA,Saint Kitts and Nevis,0,0,0,0,0,0,0
2009,KOR,South Korea,879,4399,128,42,0,0,5448
2009,KWT,Kuwait,0,0,0,21,0,1245,1266
2009,LAO,Laos,179404,244965,145875,2399,0,0,572643
2009,LBN,Lebanon,43,0,0,0,0,0,43
2009,LBR,Liberia,325486,102112,557,985,64,0,429204
2009,LBY,Libya,0,0,0,0,0,0,0
2009,LCA,Saint Lucia,0,0,0,0,0,0,0
2009,LIE,Liechtenstein,0,0,0,0,0,0,0
2009,LKA,Sri Lanka,50510,1887,3753,1223,0,0,57373
2009,LSO,Lesotho,1674,1115,54050,0,0,0,56839
2009,LTU,Lithuania,3519,557,43,21,42,0,4182
2009,LUX,Luxembourg,0,0,0,0,0,0,0
2009,LVA,Latvia,429,193,129,64,0,0,815
2009,MAC,Macao,0,0,0,0,0,0,0
2009,MAR,Morocco,2358,1501,2016,0,21,235,6131
2009,MDA,Moldova,25585,148,64,0,21,0,25818
2009,MDG,Madagascar,127035,1389847,2957864,36360,643,9315,4521064
2009,MEX,Mexico,483615,738507,370636,17739,1218,4096,1615811
2009,MKD,Macedonia,536,43,170,0,21,0,770
2009,MLI,Mali,3234023,641654,2585261,18247,170,127,6479482
2009,MLT,Malta,0,0,0,0,0,0,0
2009,MMR,Myanmar,953381,2869851,779013,10857,85,0,4613187
2009,MNE,Montenegro,21,64,43,0,0,0,128
2009,MNG,Mongolia,107390,192441,164169,1823,0,1759,467582
2009,MNP,Northern Mariana Islands,0,0,0,0,0,0,0
2009,MOZ,Mozambique,1878716,11940263,5339826,579443,427,116172,19854847
2009,MRT,Mauritania,144723,1888,221376,2211,0,514,370712
2009,MSR,Montserrat,0,0,0,0,0,0,0
2009,MTQ,Martinique,0,0,0,0,0,0,0
2009,MUS,Mauritius,0,0,0,0,0,0,0
2009,MWI,Malawi,145473,149054,82594,11073,193,42,388429
2009,MYS,Malaysia,64007,26465,5022,1541,385,0,97420
2009,MYT,Mayotte,0,0,0,0,0,0,0
2009,NAM,Namibia,277361,1084710,3977579,15840,2896,7618,5366004
2009,NCL,New Caledonia,0,0,0,0,0,0,0
2009,NER,Niger,84467,106,159555,2360,0,1093,247581
2009,NGA,Nigeria,3590674,1734504,1527083,112776,705,536,6966278
2009,NIC,Nicaragua,43185,40757,15322,4655,86,0,104005
2009,NLD,Netherlands,0,0,0,0,0,0,0
2009,NOR,Norway,0,0,0,0,0,0,0
2009,NPL,Nepal,24062,175142,8803,64,0,21,208092
2009,NRU,Nauru,0,0,0,0,0,0,0
2009,NZL,New Zealand,0,21,0,107,0,0,128
2009,OMN,Oman,0,0,21,0,0,43,64
2009,PAK,Pakistan,161462,16333,8733,4528,64,10282,201402
2009,PAN,Panama,44992,15108,3992,578,21,0,64691
2009,PER,Peru,14957,25393,18438,771,86,2316,61961
2009,PHL,Philippines,66966,2976,8560,362,128,0,78992
2009,PLW,Palau,0,0,0,0,0,0,0
2009,PNG,Papua New Guinea,118041,22127,42263,2247,643,0,185321
2009,POL,Poland,2144,84,278,193,129,0,2828
2009,PRI,Puerto Rico,21,0,429,0,0,0,450
2009,PRK,North Korea,28591,81482,2403,1005,107,150,113738
2009,PRT,Portugal,19507,43251,4571,127,42,21,67519
2009,PRY,Paraguay,310591,564809,387220,319146,106,0,1581872
2009,PSE,Palestina,0,0,0,0,0,0,0
2009,PYF,French Polynesia,0,0,0,0,0,0,0
2009,QAT,Qatar,0,0,43,0,64,794,901
2009,REU,Reunion,0,0,0,0,0,0,0
2009,ROU,Romania,127823,3603,3579,1822,386,0,137213
2009,RUS,Russia,6519357,4154933,1854580,321165,25572,77030,12952637
2009,RWA,Rwanda,1201,3563,6869,1845,0,0,13478
2009,SAU,Saudi Arabia,19361,0,235,85,107,5924,25712
2009,SDN,Sudan,2937304,1244931,4290342,60142,729,2489,8535937
2009,SEN,Senegal,740077,1386282,1923468,6824,0,0,4056651
2009,SGP,Singapore,0,0,0,0,0,0,0
2009,SHN,Saint Helena,0,0,0,0,0,0,0
2009,SJM,Svalbard and Jan Mayen,0,0,0,0,0,0,0
2009,SLB,Solomon Islands,0,0,0,0,0,0,0
2009,SLE,Sierra Leone,462934,277189,50485,12492,557,43,803700
2009,SLV,El Salvador,4055,597,0,21,0,0,4673
2009,SMR,San Marino,0,0,0,0,0,0,0
2009,SOM,Somalia,3692,815,7663,451,0,0,12621
2009,SPM,Saint Pierre and Miquelon,0,0,0,0,0,0,0
2009,SRB,Serbia,40266,1587,3176,0,214,0,45243
2009,SSD,South Sudan,681582,14636673,17505181,1353316,234,86,34177072
2009,STP,São Tomé and Príncipe,0,0,0,0,0,0,0
2009,SUR,Suriname,2212,12125,23998,234,21,0,38590
2009,SVK,Slovakia,322,64,0,0,0,0,386
2009,SVN,Slovenia,0,86,0,0,0,0,86
2009,SWE,Sweden,107,0,0,0,0,0,107
2009,SWZ,Swaziland,15302,13351,24188,128,21,966,53956
2009,SYC,Seychelles,0,0,0,0,0,0,0
2009,SYR,Syria,28334,21,42,234,42,879,29552
2009,TCA,Turks and Caicos Islands,0,322,0,0,0,0,322
2009,TCD,Chad,2197285,1070308,5154423,144375,620,687,8567698
2009,TGO,Togo,553753,449107,169387,363,149,0,1172759
2009,THA,Thailand,781621,540621,76021,8446,278,21,1407008
2009,TJK,Tajikistan,2662,0,365,0,0,0,3027
2009,TKL,Tokelau,0,0,0,0,0,0,0
2009,TKM,Turkmenistan,53601,0,17258,1672,0,20667,93198
2009,TLS,Timor-Leste,10021,750,0,0,0,0,10771
2009,TON,Tonga,0,0,0,0,0,0,0
2009,TTO,Trinidad and Tobago,558,86,21,0,0,0,665
2009,TUN,Tunisia,1136,21,192,0,0,85,1434
2009,TUR,Turkey,1312675,3405,12852,3300,1218,2226,1335676
2009,TUV,Tuvalu,0,0,0,0,0,0,0
2009,TWN,Taiwan,1309,215,0,0,43,0,1567
2009,TZA,Tanzania,1105698,9115151,3339727,1253725,362,4096,14818759
2009,UGA,Uganda,309782,877629,719163,9579,192,0,1916345
2009,UKR,Ukraine,2324235,56443,33437,4431,28838,63,2447447
2009,UMI,United States Minor Outlying Islands,0,0,0,0,0,0,0
2009,URY,Uruguay,12572,5252,12359,1328,150,0,31661
2009,USA,United States,696510,1037183,1287577,53433,1518,19698,3095919
2009,UZB,Uzbekistan,25007,43,29902,300,0,2167,57419
2009,VCT,Saint Vincent and the Grenadines,0,0,0,0,0,0,0
2009,VEN,Venezuela,281346,218191,1917490,345142,513,64,2762746
2009,VGB,British Virgin Islands,0,0,0,0,0,0,0
2009,VIR,"Virgin Islands, U.S.",0,0,0,0,0,0,0
2009,VNM,Vietnam,476659,215396,65824,2398,490,0,760767
2009,VUT,Vanuatu,0,0,0,0,0,0,0
2009,WLF,Wallis and Futuna,0,0,0,0,0,0,0
2009,WSM,Samoa,0,0,0,0,0,0,0
2009,XAD,Akrotiri and Dhekelia,0,0,0,0,0,0,0
2009,XKO,Kosovo,365,301,258,0,0,0,924
2009,XNC,Northern Cyprus,0,0,0,0,0,0,0
2009,YEM,Yemen,0,0,0,0,0,0,0
2009,ZAF,South Africa,714208,279505,3169219,19035,2268,5685,4189920
2009,ZMB,Zambia,2954325,12995220,4280225,429529,874,257,20660430
2009,ZWE,Zimbabwe,889241,1328907,2272954,6458,255,877,4498692
2010,AFG,Afghanistan,3627,236,40740,42,0,28162,72807
2010,AGO,Angola,1003938,22355452,15178084,80576,3126,1694,38622870
2010,ALA,Åland,0,0,0,0,0,0,0
2010,ALB,Albania,8414,236,1031,0,0,42,9723
2010,AND,Andorra,0,0,0,0,0,0,0
2010,ARE,United Arab Emirates,0,0,0,0,21,64,85
2010,ARG,Argentina,874983,497165,944665,310476,1455,1650,2630394
2010,ARM,Armenia,46214,6458,21163,64,0,129,74028
2010,ASM,American Samoa,0,0,0,0,0,0,0
2010,ATF,French Southern Territories,0,0,0,0,0,0,0
2010,ATG,Antigua and Barbuda,0,0,0,0,0,0,0
2010,AUS,Australia,446535,2337891,15635179,116517,127,9893,18546142
2010,AUT,Austria,0,0,0,0,0,0,0
2010,AZE,Azerbaijan,165888,15219,43079,64,21,213,224484
2010,BDI,Burundi,6288,11672,19985,127,42,0,38114
2010,BEL,Belgium,0,0,0,0,0,0,0
2010,BEN,Benin,269676,564506,951257,84,191,0,1785714
2010,BES,"Bonaire, Sint Eustatius and Saba",0,0,0,0,0,0,0
2010,BFA,Burkina Faso,1460170,315783,1259593,4678,0,0,3040224
2010,BGD,Bangladesh,8500,8931,8394,128,0,0,25953
2010,BGR,Bulgaria,48210,5447,106,63,21,0,53847
2010,BHR,Bahrain,0,0,0,0,0,0,0
2010,BHS,Bahamas,149,7705,63,707,0,21,8645
2010,BIH,Bosnia and Herzegovina,729,1673,1739,0,0,0,4141
2010,BLR,Belarus,9765,2703,599,64,0,0,13131
2010,BLZ,Belize,3563,18739,6568,1673,42,0,30585
2010,BMU,Bermuda,0,0,0,0,0,0,0
2010,BOL,Bolivia,1148420,4972780,1997160,1240297,555,192,9359404
2010,BRA,Brazil,8200431,8388009,18184784,1590113,14880,6587,36384804
2010,BRB,Barbados,515,0,21,0,0,0,536
2010,BRN,Brunei,0,0,0,64,0,0,64
2010,BTN,Bhutan,2254,11591,299,0,0,0,14144
2010,BWA,Botswana,576978,474823,12340938,2122,128,11718,13406707
2010,CAF,Central African Republic,357988,16654177,2944597,12399,620,107,19969888
2010,CAN,Canada,87343,1970524,308314,146090,106,11523,2523900
2010,CHE,Switzerland,0,0,0,0,0,0,0
2010,CHL,Chile,16912,17794,41942,21,64,406,77139
2010,CHN,China,3424524,562506,133253,22918,31502,11247,4185950
2010,CIV,Côte d'Ivoire,203237,1768355,304729,1049,360,0,2277730
2010,CMR,Cameroon,408794,3161942,624120,55508,621,0,4250985
2010,COD,Democratic Republic of the Congo,3109073,27316583,3686473,1689540,4864,1394,35807927
2010,COG,Republic of Congo,448097,2063876,1196222,26633,107,0,3734935
2010,COL,Colombia,37198,92021,1537144,200829,85,21,1867298
2010,COM,Comoros,387,300,64,0,0,0,751
2010,CPV,Cape Verde,0,0,0,0,0,0,0
2010,CRI,Costa Rica,19426,7749,299,171,0,0,27645
2010,CUB,Cuba,119148,19678,16630,3924,0,0,159380
2010,CYM,Cayman Islands,0,0,0,0,0,0,0
2010,CYP,Cyprus,343,64,128,0,0,21,556
2010,CZE,Czech Republic,214,64,0,0,0,0,278
2010,DEU,Germany,0,0,0,0,0,0,0
2010,DJI,Djibouti,0,0,0,0,0,21,21
2010,DMA,Dominica,0,0,0,0,0,0,0
2010,DNK,Denmark,0,0,0,0,0,0,0
2010,DOM,Dominican Republic,26573,2187,1673,1587,107,0,32127
2010,DZA,Algeria,34919,19229,24488,258,42,9035,87971
2010,ECU,Ecuador,4293,2615,1930,1695,0,0,10533
2010,EGY,Egypt,40184,0,0,193,1522,43,41942
2010,ERI,Eritrea,3734,21,772,0,21,301,4849
2010,ESH,Western Sahara,0,0,0,0,0,0,0
2010,ESP,Spain,9250,12812,7918,343,86,42,30451
2010,EST,Estonia,299,21,0,0,0,0,320
2010,ETH,Ethiopia,374020,3276549,1710311,33032,128,25735,5419775
2010,FIN,Finland,279,665,0,0,0,0,944
2010,FJI,Fiji,3520,1310,171,42,0,0,5043
2010,FRA,France,25951,3153,6716,0,299,0,36119
2010,FRO,Faroe Islands,0,0,0,0,0,0,0
2010,FSM,Micronesia,0,0,0,0,0,0,0
2010,GAB,Gabon,11376,156163,202488,429,0,0,370456
2010,GBR,United Kingdom,0,107,2404,1245,0,86,3842
2010,GEO,Georgia,22711,4595,5451,0,0,21,32778
2010,GGY,Guernsey,0,0,0,0,0,0,0
2010,GHA,Ghana,1215700,3046608,1450105,14424,363,257,5727457
2010,GIN,Guinea,279830,2688021,442285,15237,362,42,3425777
2010,GLP,Guadeloupe,21,0,0,0,0,0,21
2010,GMB,Gambia,175246,38870,29644,6934,21,214,250929
2010,GNB,Guinea-Bissau,22819,363397,7467,11525,64,84,405356
2010,GNQ,Equatorial Guinea,0,21,0,0,0,0,21
2010,GRC,Greece,14294,1266,3863,86,0,257,19766
2010,GRD,Grenada,0,0,0,0,0,0,0
2010,GRL,Greenland,0,0,0,0,0,0,0
2010,GTM,Guatemala,172433,85772,29945,1069,406,536,290161
2010,GUF,French Guiana,193,880,836,837,258,0,3004
2010,GUM,Guam,0,0,0,0,0,0,0
2010,GUY,Guyana,12209,34346,16076,6138,0,0,68769
2010,HKG,Hong Kong,472,150,0,0,0,0,622
2010,HND,Honduras,30800,71026,75148,1627,192,0,178793
2010,HRV,Croatia,1029,193,172,0,0,0,1394
2010,HTI,Haiti,279,21,794,236,0,0,1330
2010,HUN,Hungary,2512,0,0,0,0,0,2512
2010,IDN,Indonesia,63319,17058,34688,1432,450,0,116947
2010,IMN,Isle of Man,0,0,0,0,0,0,0
2010,IND,India,2892817,1724111,170861,11905,14377,665,4814736
2010,IRL,Ireland,0,127,1073,6848,0,0,8048
2010,IRN,Iran,508196,17042,25343,2059,1969,19653,574262
2010,IRQ,Iraq,175861,2573,13114,1587,126,10515,203776
2010,ISL,Iceland,0,0,0,0,0,0,0
2010,ISR,Israel,6181,2916,1760,0,43,214,11114
2010,ITA,Italy,68453,235,9038,84,128,106,78044
2010,JAM,Jamaica,1009,150,43,0,0,0,1202
2010,JEY,Jersey,0,0,0,0,0,0,0
2010,JOR,Jordan,0,0,43,0,0,0,43
2010,JPN,Japan,4423,4399,2232,21,0,0,11075
2010,KAZ,Kazakhstan,3556994,38719,8293554,30562,1391,15321,11936541
2010,KEN,Kenya,68839,52074,52330,8819,0,729,182791
2010,KGZ,Kyrgyzstan,3605,150,6073,0,0,4680,14508
2010,KHM,Cambodia,708427,1770410,53144,53808,0,321,2586110
2010,KNA,Saint Kitts and Nevis,43,21,21,0,0,0,85
2010,KOR,South Korea,623,365,0,43,0,0,1031
2010,KWT,Kuwait,0,0,0,0,0,2061,2061
2010,LAO,Laos,342739,704722,530842,5745,0,0,1584048
2010,LBN,Lebanon,278,0,471,0,0,43,792
2010,LBR,Liberia,17450,7083,0,64,0,0,24597
2010,LBY,Libya,0,0,0,0,0,107,107
2010,LCA,Saint Lucia,0,0,0,0,0,0,0
2010,LIE,Liechtenstein,0,0,0,0,0,0,0
2010,LKA,Sri Lanka,25221,341,1243,1029,0,0,27834
2010,LSO,Lesotho,2230,2874,41342,43,21,0,46510
2010,LTU,Lithuania,192,0,0,0,0,0,192
2010,LUX,Luxembourg,0,0,0,0,0,0,0
2010,LVA,Latvia,279,472,278,0,0,0,1029
2010,MAC,Macao,0,0,0,0,0,0,0
2010,MAR,Morocco,1652,1266,1137,0,43,64,4162
2010,MDA,Moldova,36813,577,106,21,408,0,37925
2010,MDG,Madagascar,183982,1463350,2605892,36664,513,7191,4297592
2010,MEX,Mexico,379072,387235,208251,8964,1390,6111,991023
2010,MKD,Macedonia,1523,236,408,0,0,64,2231
2010,MLI,Mali,3327448,636504,3181308,10967,0,1351,7157578
2010,MLT,Malta,0,0,0,0,0,0,0
2010,MMR,Myanmar,1173535,3178323,758625,10622,42,0,5121147
2010,MNE,Montenegro,300,472,0,0,0,0,772
2010,MNG,Mongolia,51386,7105,199845,3413,0,1415,263164
2010,MNP,Northern Mariana Islands,0,0,0,0,0,0,0
2010,MOZ,Mozambique,2036119,14703713,5558325,567274,320,133474,22999225
2010,MRT,Mauritania,181324,5817,457864,343,0,837,646185
2010,MSR,Montserrat,64,451,0,0,0,0,515
2010,MTQ,Martinique,0,0,0,0,0,0,0
2010,MUS,Mauritius,1674,21,0,0,0,0,1695
2010,MWI,Malawi,232556,310774,119122,25296,84,1502,689334
2010,MYS,Malaysia,40997,16222,665,1953,128,0,59965
2010,MYT,Mayotte,0,0,0,0,0,0,0
2010,NAM,Namibia,241638,730483,3770625,11526,469,3411,4758152
2010,NCL,New Caledonia,0,0,0,0,0,0,0
2010,NER,Niger,76720,343,173059,13673,0,43,263838
2010,NGA,Nigeria,3906513,2501430,1739204,81498,2293,385,8231323
2010,NIC,Nicaragua,34640,85324,109496,9336,128,0,238924
2010,NLD,Netherlands,0,0,0,0,0,0,0
2010,NOR,Norway,0,0,0,0,0,0,0
2010,NPL,Nepal,23786,193621,2897,0,0,0,220304
2010,NRU,Nauru,0,0,0,0,0,0,0
2010,NZL,New Zealand,21,86,1095,43,0,21,1266
2010,OMN,Oman,0,0,0,0,0,0,0
2010,PAK,Pakistan,189195,708,3777,7147,128,170,201125
2010,PAN,Panama,13973,728,771,170,21,107,15770
2010,PER,Peru,38460,118832,72768,921,214,1177,232372
2010,PHL,Philippines,119556,33970,7914,706,42,0,162188
2010,PLW,Palau,0,0,0,0,0,0,0
2010,PNG,Papua New Guinea,169296,11922,24835,2401,941,0,209395
2010,POL,Poland,8130,257,278,322,86,0,9073
2010,PRI,Puerto Rico,279,172,1523,0,0,0,1974
2010,PRK,North Korea,5279,9573,449,192,0,43,15536
2010,PRT,Portugal,45784,98506,6591,213,84,299,151477
2010,PRY,Paraguay,326942,531552,467264,296433,298,0,1622489
2010,PSE,Palestina,107,0,64,0,0,0,171
2010,PYF,French Polynesia,0,0,0,0,0,0,0
2010,QAT,Qatar,0,0,0,0,0,86,86
2010,REU,Reunion,85,343,472,0,0,0,900
2010,ROU,Romania,226035,3086,1668,2917,384,0,234090
2010,RUS,Russia,3976241,4510010,2155674,212118,19606,109427,10983076
2010,RWA,Rwanda,2446,5086,26445,1909,0,0,35886
2010,SAU,Saudi Arabia,18031,0,21,0,0,4077,22129
2010,SDN,Sudan,1877765,1033105,3626743,59884,557,1050,6599104
2010,SEN,Senegal,687597,1371324,2618187,11307,0,21,4688436
2010,SGP,Singapore,0,0,0,0,0,0,0
2010,SHN,Saint Helena,0,0,0,0,0,0,0
2010,SJM,Svalbard and Jan Mayen,0,0,0,0,0,0,0
2010,SLB,Solomon Islands,0,0,0,0,0,0,0
2010,SLE,Sierra Leone,160007,226850,18611,1972,149,0,407589
2010,SLV,El Salvador,1351,364,0,0,0,0,1715
2010,SMR,San Marino,0,0,0,0,0,0,0
2010,SOM,Somalia,19124,322,5688,644,407,0,26185
2010,SPM,Saint Pierre and Miquelon,0,0,0,0,0,0,0
2010,SRB,Serbia,9895,428,1374,42,0,0,11739
2010,SSD,South Sudan,539353,12139205,10714899,1227438,169,64,24621128
2010,STP,São Tomé and Príncipe,0,0,0,0,0,0,0
2010,SUR,Suriname,988,4765,300,236,0,0,6289
2010,SVK,Slovakia,129,0,0,0,0,0,129
2010,SVN,Slovenia,0,0,0,0,0,0,0
2010,SWE,Sweden,0,0,0,0,0,0,0
2010,SWZ,Swaziland,28486,35007,42415,42,299,730,106979
2010,SYC,Seychelles,0,0,0,0,0,0,0
2010,SYR,Syria,41342,107,149,128,128,515,42369
2010,TCA,Turks and Caicos Islands,0,0,0,0,0,0,0
2010,TCD,Chad,2114430,1389349,5698654,149036,836,152558,9504863
2010,TGO,Togo,360216,437130,157386,150,322,0,955204
2010,THA,Thailand,823274,441376,115298,8961,365,0,1389274
2010,TJK,Tajikistan,3584,0,1610,0,0,43,5237
2010,TKL,Tokelau,0,0,0,0,0,0,0
2010,TKM,Turkmenistan,34711,494,209478,170,0,48081,292934
2010,TLS,Timor-Leste,0,0,0,0,0,0,0
2010,TON,Tonga,0,0,0,0,0,0,0
2010,TTO,Trinidad and Tobago,4336,2230,21,0,0,0,6587
2010,TUN,Tunisia,1245,3090,279,0,0,6911,11525
2010,TUR,Turkey,786545,2975,12012,1730,1024,961,805247
2010,TUV,Tuvalu,0,0,0,0,0,0,0
2010,TWN,Taiwan,257,43,0,0,0,0,300
2010,TZA,Tanzania,1332300,9376586,3796152,1248818,169,4183,15758208
2010,UGA,Uganda,644851,1464736,1209250,10958,213,21,3330029
2010,UKR,Ukraine,1209850,42726,17479,2697,21905,64,1294721
2010,UMI,United States Minor Outlying Islands,0,0,0,0,0,0,0
2010,URY,Uruguay,11774,5662,16671,1350,85,0,35542
2010,USA,United States,1056129,513112,789926,67348,1152,11325,2438992
2010,UZB,Uzbekistan,3605,43,1824,450,0,235,6157
2010,VCT,Saint Vincent and the Grenadines,0,0,0,0,0,0,0
2010,VEN,Venezuela,376074,482740,1514629,277056,491,84,2651074
2010,VGB,British Virgin Islands,0,0,0,0,0,0,0
2010,VIR,"Virgin Islands, U.S.",0,0,0,0,0,0,0
2010,VNM,Vietnam,852336,284585,130240,6773,941,0,1274875
2010,VUT,Vanuatu,0,0,0,0,0,0,0
2010,WLF,Wallis and Futuna,0,0,0,0,0,0,0
2010,WSM,Samoa,0,0,0,0,0,0,0
2010,XAD,Akrotiri and Dhekelia,0,0,0,0,0,0,0
2010,XKO,Kosovo,343,773,0,0,0,0,1116
2010,XNC,Northern Cyprus,107,0,86,0,0,258,451
2010,YEM,Yemen,0,0,0,0,0,0,0
2010,ZAF,South Africa,667977,318290,3640826,17959,3750,4310,4653112
2010,ZMB,Zambia,3296663,15418566,4541426,551645,1242,192,23809734
2010,ZWE,Zimbabwe,1002944,1458730,2260699,9035,254,1586,4733248
2011,AFG,Afghanistan,4013,0,11613,429,0,21,16076
2011,AGO,Angola,1041966,22560858,15895276,78216,3407,1115,39580838
2011,ALA,Åland,0,0,0,0,0,0,0
2011,ALB,Albania,30866,6738,3304,256,0,472,41636
2011,AND,Andorra,0,0,0,0,0,0,0
2011,ARE,United Arab Emirates,0,0,0,0,0,0,0
2011,ARG,Argentina,1062983,648022,1089927,568127,1265,2076,3372400
2011,ARM,Armenia,3842,319,1737,0,0,0,5898
2011,ASM,American Samoa,0,0,0,0,0,0,0
2011,ATF,French Southern Territories,0,0,0,0,0,0,0
2011,ATG,Antigua and Barbuda,0,0,0,0,0,0,0
2011,AUS,Australia,1174956,5710632,79328119,141411,855,2040847,88396820
2011,AUT,Austria,3220,42,0,0,0,0,3262
2011,AZE,Azerbaijan,176058,7020,12533,64,0,149,195824
2011,BDI,Burundi,2640,8668,13308,21,0,0,24637
2011,BEL,Belgium,64,107,21,687,0,0,879
2011,BEN,Benin,314557,720647,989231,708,448,85,2025676
2011,BES,"Bonaire, Sint Eustatius and Saba",0,0,0,21,0,0,21
2011,BFA,Burkina Faso,1338347,291717,1257469,2853,21,0,2890407
2011,BGD,Bangladesh,10925,8587,10948,321,0,0,30781
2011,BGR,Bulgaria,89891,5598,987,814,234,128,97652
2011,BHR,Bahrain,0,0,0,0,0,0,0
2011,BHS,Bahamas,492,41878,2251,1929,128,64,46742
2011,BIH,Bosnia and Herzegovina,7642,11742,12449,1309,21,0,33163
2011,BLR,Belarus,4077,1265,129,450,150,0,6071
2011,BLZ,Belize,19320,80003,13759,1115,21,21,114239
2011,BMU,Bermuda,0,0,0,0,0,0,0
2011,BOL,Bolivia,658764,1437201,675013,514513,299,1030,3286820
2011,BRA,Brazil,4136042,2182171,7216499,642566,6789,5516,14189583
2011,BRB,Barbados,0,0,0,0,0,0,0
2011,BRN,Brunei,0,0,0,0,0,0,0
2011,BTN,Bhutan,1009,6309,770,0,0,0,8088
2011,BWA,Botswana,617249,803378,15111712,3669,63,8737,16544808
2011,CAF,Central African Republic,316551,18984902,3092926,15770,491,148,22410788
2011,CAN,Canada,62185,1215398,273817,89918,214,2486,1644018
2011,CHE,Switzerland,0,0,0,0,0,0,0
2011,CHL,Chile,15004,35050,40437,3369,86,1500,95446
2011,CHN,China,2730766,223408,109658,38397,36704,4420,3143353
2011,CIV,Côte d'Ivoire,269758,2099982,331519,2596,1348,0,2705203
2011,CMR,Cameroon,416694,2468417,543492,53576,321,0,3482500
2011,COD,Democratic Republic of the Congo,2909046,25830193,3408135,1524755,5181,515,33677825
2011,COG,Republic of Congo,406878,2169097,1171584,35350,63,0,3782972
2011,COL,Colombia,49646,124128,1212492,117648,43,0,1503957
2011,COM,Comoros,301,236,236,0,0,0,773
2011,CPV,Cape Verde,0,0,0,0,0,0,0
2011,CRI,Costa Rica,13826,2017,214,193,43,0,16293
2011,CUB,Cuba,162389,51560,54521,5721,63,21,274275
2011,CYM,Cayman Islands,0,0,0,0,0,0,0
2011,CYP,Cyprus,580,0,0,0,0,0,580
2011,CZE,Czech Republic,405,107,0,0,0,0,512
2011,DEU,Germany,214,214,451,0,0,0,879
2011,DJI,Djibouti,0,0,0,0,0,322,322
2011,DMA,Dominica,0,0,0,0,0,0,0
2011,DNK,Denmark,21,0,0,0,0,0,21
2011,DOM,Dominican Republic,17277,3495,2228,2572,21,0,25593
2011,DZA,Algeria,16011,44024,4140,429,21,750,65375
2011,ECU,Ecuador,38273,6628,16033,2639,0,43,63616
2011,EGY,Egypt,30437,0,0,64,837,0,31338
2011,ERI,Eritrea,1501,1803,5431,43,0,14060,22838
2011,ESH,Western Sahara,0,0,0,0,0,0,0
2011,ESP,Spain,22144,52976,11800,729,43,193,87885
2011,EST,Estonia,85,21,21,0,0,0,127
2011,ETH,Ethiopia,429725,3486916,1670277,35202,257,25370,5647747
2011,FIN,Finland,644,923,43,1009,150,0,2769
2011,FJI,Fiji,0,0,0,0,0,0,0
2011,FRA,France,13180,2788,2445,43,43,0,18499
2011,FRO,Faroe Islands,0,0,0,0,0,0,0
2011,FSM,Micronesia,0,0,0,0,0,0,0
2011,GAB,Gabon,26811,199283,254500,708,107,0,481409
2011,GBR,United Kingdom,1073,300,3690,1738,193,0,6994
2011,GEO,Georgia,8308,192,429,0,0,0,8929
2011,GGY,Guernsey,0,0,0,0,0,0,0
2011,GHA,Ghana,1558654,4357417,1747362,26615,599,107,7690754
2011,GIN,Guinea,466301,2935822,512713,25091,426,106,3940459
2011,GLP,Guadeloupe,0,0,0,0,0,0,0
2011,GMB,Gambia,197831,36790,39280,7940,0,236,282077
2011,GNB,Guinea-Bissau,32346,282080,13308,15579,0,171,343484
2011,GNQ,Equatorial Guinea,0,43,0,0,0,0,43
2011,GRC,Greece,52206,7490,12622,235,21,149,72723
2011,GRD,Grenada,0,0,0,0,0,0,0
2011,GRL,Greenland,0,0,0,0,0,0,0
2011,GTM,Guatemala,180437,72311,14875,620,236,86,268565
2011,GUF,French Guiana,0,21,0,42,0,0,63
2011,GUM,Guam,0,0,0,0,0,0,0
2011,GUY,Guyana,13156,11438,26467,921,450,0,52432
2011,HKG,Hong Kong,85,86,0,21,0,0,192
2011,HND,Honduras,99064,281387,56730,1520,107,0,438808
2011,HRV,Croatia,15045,7488,3627,322,21,0,26503
2011,HTI,Haiti,386,0,1672,128,0,0,2186
2011,HUN,Hungary,11655,256,85,43,0,0,12039
2011,IDN,Indonesia,563926,146781,107368,6538,2960,0,827573
2011,IMN,Isle of Man,0,0,0,0,0,0,0
2011,IND,India,3112689,1060685,127560,8211,17385,256,4326786
2011,IRL,Ireland,0,193,1116,4250,0,0,5559
2011,IRN,Iran,163709,665,17188,1865,1114,118660,303201
2011,IRQ,Iraq,56307,1910,4073,2745,84,12232,77351
2011,ISL,Iceland,0,0,0,0,0,0,0
2011,ISR,Israel,1803,601,107,0,21,64,2596
2011,ITA,Italy,74159,4463,7985,215,449,365,87636
2011,JAM,Jamaica,1330,300,0,0,0,0,1630
2011,JEY,Jersey,0,0,0,0,0,0,0
2011,JOR,Jordan,215,0,21,0,0,0,236
2011,JPN,Japan,6654,4915,2598,106,0,0,14273
2011,KAZ,Kazakhstan,1067285,27818,1669677,20752,234,39235,2825001
2011,KEN,Kenya,54433,31337,55677,4420,0,2040,147907
2011,KGZ,Kyrgyzstan,6653,106,5129,0,0,622,12510
2011,KHM,Cambodia,847770,2273934,69068,15773,0,0,3206545
2011,KNA,Saint Kitts and Nevis,0,0,0,0,0,0,0
2011,KOR,South Korea,8006,10798,643,300,86,64,19897
2011,KWT,Kuwait,0,0,0,0,0,42,42
2011,LAO,Laos,115355,141263,63452,1584,0,0,321654
2011,LBN,Lebanon,0,0,0,0,0,0,0
2011,LBR,Liberia,20606,17641,193,85,215,0,38740
2011,LBY,Libya,2382,0,107,0,0,6182,8671
2011,LCA,Saint Lucia,0,0,0,0,0,0,0
2011,LIE,Liechtenstein,0,0,0,0,0,0,0
2011,LKA,Sri Lanka,32667,1094,1435,987,0,0,36183
2011,LSO,Lesotho,1588,2489,100179,0,0,0,104256
2011,LTU,Lithuania,193,86,0,301,0,0,580
2011,LUX,Luxembourg,0,0,0,0,0,0,0
2011,LVA,Latvia,0,0,0,0,0,0,0
2011,MAC,Macao,0,0,0,0,0,0,0
2011,MAR,Morocco,793,1846,2339,0,0,64,5042
2011,MDA,Moldova,36918,1563,191,42,599,0,39313
2011,MDG,Madagascar,171554,1273181,2750315,23461,812,3542,4222865
2011,MEX,Mexico,568317,1796598,729559,14134,1860,4093,3114561
2011,MKD,Macedonia,6907,3646,6502,0,0,107,17162
2011,MLI,Mali,2860541,727069,3075714,22130,64,878,6686396
2011,MLT,Malta,0,0,0,0,0,0,0
2011,MMR,Myanmar,653245,1557064,313595,4608,0,0,2528512
2011,MNE,Montenegro,3647,8456,364,450,0,0,12917
2011,MNG,Mongolia,349397,22343,1440099,3092,0,5816,1820747
2011,MNP,Northern Mariana Islands,0,0,0,0,0,0,0
2011,MOZ,Mozambique,1695523,11931800,5693496,540974,426,106831,19969050
2011,MRT,Mauritania,97328,5795,186344,2445,0,365,292277
2011,MSR,Montserrat,0,0,0,0,0,0,0
2011,MTQ,Martinique,0,0,0,0,0,0,0
2011,MUS,Mauritius,0,0,0,0,0,0,0
2011,MWI,Malawi,229463,214436,79885,33697,105,42,557628
2011,MYS,Malaysia,35308,8047,171,319,214,0,44059
2011,MYT,Mayotte,0,0,0,0,0,0,0
2011,NAM,Namibia,384515,1479623,6353379,15474,1501,187585,8422077
2011,NCL,New Caledonia,364,0,601,0,0,0,965
2011,NER,Niger,58534,0,139161,11591,0,172,209458
2011,NGA,Nigeria,3307429,2074348,1644793,97385,4802,384,7129141
2011,NIC,Nicaragua,47116,63406,30908,5429,190,0,147049
2011,NLD,Netherlands,0,0,0,0,0,0,0
2011,NOR,Norway,0,0,0,0,0,0,0
2011,NPL,Nepal,15369,104580,2273,128,0,0,122350
2011,NRU,Nauru,0,0,0,0,0,0,0
2011,NZL,New Zealand,21,64,1052,21,0,0,1158
2011,OMN,Oman,0,0,43,0,0,0,43
2011,PAK,Pakistan,122892,1394,7015,1050,63,601,133015
2011,PAN,Panama,7341,515,321,21,0,129,8327
2011,PER,Peru,14809,21849,6115,687,322,792,44574
2011,PHL,Philippines,60039,3234,5666,85,42,0,69066
2011,PLW,Palau,0,0,0,0,0,0,0
2011,PNG,Papua New Guinea,93012,11348,20926,3321,664,0,129271
2011,POL,Poland,3714,343,601,86,301,0,5045
2011,PRI,Puerto Rico,107,191,1351,0,21,0,1670
2011,PRK,North Korea,23979,53987,2574,492,129,236,81397
2011,PRT,Portugal,14032,36791,4740,42,64,0,55669
2011,PRY,Paraguay,403640,724167,524156,358367,149,149,2010628
2011,PSE,Palestina,0,0,0,0,0,0,0
2011,PYF,French Polynesia,0,0,0,0,0,0,0
2011,QAT,Qatar,0,0,43,0,0,343,386
2011,REU,Reunion,0,923,1138,0,0,0,2061
2011,ROU,Romania,256538,8126,11608,36254,2162,0,314688
2011,RUS,Russia,3019788,6526698,2749485,296183,38561,46764,12677479
2011,RWA,Rwanda,858,1180,4444,1309,0,0,7791
2011,SAU,Saudi Arabia,11719,0,300,0,236,13459,25714
2011,SDN,Sudan,1009988,1284495,3400508,60745,620,858,5757214
2011,SEN,Senegal,823019,1912822,2796444,12277,0,150,5544712
2011,SGP,Singapore,0,0,0,0,0,0,0
2011,SHN,Saint Helena,0,0,0,0,0,0,0
2011,SJM,Svalbard and Jan Mayen,0,0,0,0,0,0,0
2011,SLB,Solomon Islands,0,0,0,0,0,0,0
2011,SLE,Sierra Leone,217726,318318,36341,3217,386,21,576009
2011,SLV,El Salvador,1717,128,0,21,21,0,1887
2011,SMR,San Marino,0,0,0,0,0,0,0
2011,SOM,Somalia,1931,322,1737,0,64,0,4054
2011,SPM,Saint Pierre and Miquelon,0,0,0,0,0,0,0
2011,SRB,Serbia,54756,3710,6953,106,42,0,65567
2011,SSD,South Sudan,530870,15728553,14531552,1120819,191,322,31912307
2011,STP,São Tomé and Príncipe,0,0,0,0,0,0,0
2011,SUR,Suriname,795,6179,13029,192,64,0,20259
2011,SVK,Slovakia,1781,0,0,0,0,21,1802
2011,SVN,Slovenia,86,1415,0,0,0,0,1501
2011,SWE,Sweden,0,0,0,0,0,0,0
2011,SWZ,Swaziland,22729,29190,31703,42,128,987,84779
2011,SYC,Seychelles,0,0,0,0,0,0,0
2011,SYR,Syria,11225,0,170,43,63,599,12100
2011,TCA,Turks and Caicos Islands,0,0,0,0,0,0,0
2011,TCD,Chad,2855472,1308578,6479364,112951,620,55768,10812753
2011,TGO,Togo,839745,676559,212144,836,320,0,1729604
2011,THA,Thailand,565854,206287,20425,2887,84,0,795537
2011,TJK,Tajikistan,1524,21,21,258,0,42,1866
2011,TKL,Tokelau,0,0,0,0,0,0,0
2011,TKM,Turkmenistan,26852,0,3991,407,0,3177,34427
2011,TLS,Timor-Leste,2427,600,0,0,0,0,3027
2011,TON,Tonga,0,0,0,0,0,0,0
2011,TTO,Trinidad and Tobago,0,0,0,0,0,0,0
2011,TUN,Tunisia,2682,3930,0,21,0,1159,7792
2011,TUR,Turkey,960206,7571,16306,1735,980,1948,988746
2011,TUV,Tuvalu,0,0,0,0,0,0,0
2011,TWN,Taiwan,0,0,0,0,0,0,0
2011,TZA,Tanzania,901502,8131845,2879772,1184884,362,2939,13101304
2011,UGA,Uganda,574305,596981,559261,18876,234,0,1749657
2011,UKR,Ukraine,1172737,32511,29953,9672,11778,149,1256800
2011,UMI,United States Minor Outlying Islands,0,0,0,0,0,0,0
2011,URY,Uruguay,8854,4325,7867,1800,149,0,22995
2011,USA,United States,832718,1216215,2152054,109287,3256,7891,4321421
2011,UZB,Uzbekistan,30954,0,5364,4679,21,578,41596
2011,VCT,Saint Vincent and the Grenadines,0,0,0,0,0,0,0
2011,VEN,Venezuela,99682,104055,1147754,234422,257,42,1586212
2011,VGB,British Virgin Islands,0,0,0,0,0,0,0
2011,VIR,"Virgin Islands, U.S.",0,0,0,0,0,0,0
2011,VNM,Vietnam,445174,184837,36158,2160,513,0,668842
2011,VUT,Vanuatu,0,0,0,0,0,0,0
2011,WLF,Wallis and Futuna,0,0,0,0,0,0,0
2011,WSM,Samoa,1309,0,0,0,0,0,1309
2011,XAD,Akrotiri and Dhekelia,0,0,0,0,0,0,0
2011,XKO,Kosovo,1649,2918,7985,0,21,150,12723
2011,XNC,Northern Cyprus,472,0,257,0,0,0,729
2011,YEM,Yemen,0,0,21,106,0,235,362
2011,ZAF,South Africa,557492,263918,3670014,18798,5792,4889,4520903
2011,ZMB,Zambia,3241774,14716951,4627423,547206,1048,150,23134552
2011,ZWE,Zimbabwe,921375,1530060,2202137,8028,277,790,4662667
2012,AFG,Afghanistan,472,0,1974,0,0,3391,5837
2012,AGO,Angola,922125,21295187,14778347,80492,1691,879,37078721
2012,ALA,Åland,0,0,0,0,0,0,0
2012,ALB,Albania,12621,25203,5581,0,0,429,43834
2012,AND,Andorra,0,0,0,0,0,0,0
2012,ARE,United Arab Emirates,0,0,0,0,0,451,451
2012,ARG,Argentina,786142,692785,846741,623767,940,6309,2956684
2012,ARM,Armenia,3304,901,342,21,86,0,4654
2012,ASM,American Samoa,0,0,0,0,0,0,0
2012,ATF,French Southern Territories,0,0,0,0,0,0,0
2012,ATG,Antigua and Barbuda,0,0,0,0,0,0,0
2012,AUS,Australia,838391,7192393,81613417,319344,576,296871,90260992
2012,AUT,Austria,0,85,21,0,0,0,106
2012,AZE,Azerbaijan,105220,2445,22194,85,21,128,130093
2012,BDI,Burundi,4269,9465,13777,43,0,0,27554
2012,BEL,Belgium,0,0,0,0,0,0,0
2012,BEN,Benin,284404,617075,833392,170,514,42,1735597
2012,BES,"Bonaire, Sint Eustatius and Saba",0,0,0,0,0,0,0
2012,BFA,Burkina Faso,733316,262245,1011234,5321,21,0,2012137
2012,BGD,Bangladesh,3391,18847,16120,214,0,0,38572
2012,BGR,Bulgaria,170216,3837,1350,750,149,63,176365
2012,BHR,Bahrain,0,0,0,0,0,0,0
2012,BHS,Bahamas,427,9680,514,514,21,0,11156
2012,BIH,Bosnia and Herzegovina,10474,31706,22946,193,0,64,65383
2012,BLR,Belarus,17041,22278,728,2167,1137,0,43351
2012,BLZ,Belize,1974,2791,965,21,0,0,5751
2012,BMU,Bermuda,0,0,0,0,0,0,0
2012,BOL,Bolivia,323729,1014837,870868,510438,299,0,2720171
2012,BRA,Brazil,4551556,5150253,13131585,1251579,9631,3087,24097691
2012,BRB,Barbados,0,0,0,0,0,0,0
2012,BRN,Brunei,0,0,0,0,0,0,0
2012,BTN,Bhutan,2595,17665,385,0,0,0,20645
2012,BWA,Botswana,195550,341886,4430871,12878,64,1309,4982558
2012,CAF,Central African Republic,330614,13670575,2662815,6132,406,0,16670542
2012,CAN,Canada,71009,1242769,212531,64096,192,7833,1598430
2012,CHE,Switzerland,0,0,0,0,0,21,21
2012,CHL,Chile,29707,42050,37647,428,148,213,110193
2012,CHN,China,4416211,155576,186546,65376,54217,3153,4881079
2012,CIV,Côte d'Ivoire,367684,1709025,268750,1133,663,0,2347255
2012,CMR,Cameroon,348025,2152229,416028,38979,386,0,2955647
2012,COD,Democratic Republic of the Congo,3024358,24103137,3567099,1475124,5763,1116,32176597
2012,COG,Republic of Congo,361160,1953544,1188521,29468,84,0,3532777
2012,COL,Colombia,47062,108454,1211337,90449,170,21,1457493
2012,COM,Comoros,107,172,214,0,0,0,493
2012,CPV,Cape Verde,0,0,0,0,0,0,0
2012,CRI,Costa Rica,20458,12858,493,234,43,0,34086
2012,CUB,Cuba,110439,17815,15776,3062,43,0,147135
2012,CYM,Cayman Islands,0,0,0,0,0,0,0
2012,CYP,Cyprus,493,0,1180,0,0,129,1802
2012,CZE,Czech Republic,2169,63,0,0,0,0,2232
2012,DEU,Germany,128,85,21,0,21,0,255
2012,DJI,Djibouti,0,0,0,0,0,0,0
2012,DMA,Dominica,0,0,0,0,0,0,0
2012,DNK,Denmark,494,21,21,0,0,0,536
2012,DOM,Dominican Republic,8605,1693,941,1008,0,0,12247
2012,DZA,Algeria,45762,182221,54172,514,107,5278,288054
2012,ECU,Ecuador,14381,20713,13392,2209,0,129,50824
2012,EGY,Egypt,34536,0,21,129,986,0,35672
2012,ERI,Eritrea,1008,0,5087,150,0,86,6331
2012,ESH,Western Sahara,0,0,0,0,0,0,0
2012,ESP,Spain,41535,90412,71132,600,342,406,204427
2012,EST,Estonia,21,129,0,21,0,0,171
2012,ETH,Ethiopia,450675,3394892,2161569,31488,127,9872,6048623
2012,FIN,Finland,0,0,0,0,0,0,0
2012,FJI,Fiji,0,0,0,0,0,0,0
2012,FRA,France,11721,14895,15863,64,21,42,42606
2012,FRO,Faroe Islands,0,0,0,0,0,0,0
2012,FSM,Micronesia,0,0,0,0,0,0,0
2012,GAB,Gabon,22302,174021,240738,257,0,0,437318
2012,GBR,United Kingdom,150,86,2768,2318,0,64,5386
2012,GEO,Georgia,3371,171,430,0,0,0,3972
2012,GGY,Guernsey,0,0,0,0,0,0,0
2012,GHA,Ghana,1169414,3070369,1279017,11480,789,149,5531218
2012,GIN,Guinea,772338,3551463,443763,19145,319,42,4787070
2012,GLP,Guadeloupe,0,0,0,0,0,0,0
2012,GMB,Gambia,142018,38937,21335,6696,0,213,209199
2012,GNB,Guinea-Bissau,35847,463772,11226,16376,0,64,527285
2012,GNQ,Equatorial Guinea,0,21,0,0,0,0,21
2012,GRC,Greece,54907,12426,24877,683,193,577,93663
2012,GRD,Grenada,0,0,0,0,0,0,0
2012,GRL,Greenland,0,0,0,0,0,0,0
2012,GTM,Guatemala,173290,62374,10858,897,406,0,247825
2012,GUF,French Guiana,42,966,794,536,0,0,2338
2012,GUM,Guam,0,0,0,0,0,0,0
2012,GUY,Guyana,17644,23181,30718,3583,1031,0,76157
2012,HKG,Hong Kong,258,21,0,0,43,0,322
2012,HND,Honduras,15174,16888,35416,985,63,0,68526
2012,HRV,Croatia,7533,5513,8714,42,0,0,21802
2012,HTI,Haiti,85,43,814,1223,0,0,2165
2012,HUN,Hungary,15794,515,579,0,387,0,17275
2012,IDN,Indonesia,617142,188393,91461,8537,3194,0,908727
2012,IMN,Isle of Man,0,0,0,0,0,0,0
2012,IND,India,3508097,2236220,178155,12205,21870,256,5956803
2012,IRL,Ireland,0,0,21,85,0,0,106
2012,IRN,Iran,92296,836,5340,1157,341,13903,113873
2012,IRQ,Iraq,33033,2790,5149,1286,171,8410,50839
2012,ISL,Iceland,0,0,0,0,0,0,0
2012,ISR,Israel,621,0,1094,0,0,365,2080
2012,ITA,Italy,122376,14015,20179,256,1932,707,159465
2012,JAM,Jamaica,1480,300,64,0,0,0,1844
2012,JEY,Jersey,0,0,0,0,0,0,0
2012,JOR,Jordan,21,0,0,0,0,0,21
2012,JPN,Japan,794,1610,536,64,0,0,3004
2012,KAZ,Kazakhstan,3070372,35308,2615270,87209,706,19079,5827944
2012,KEN,Kenya,81027,87574,654247,42008,0,5558,870414
2012,KGZ,Kyrgyzstan,2961,471,11741,193,0,1331,16697
2012,KHM,Cambodia,670994,2115648,50741,10362,21,21,2847787
2012,KNA,Saint Kitts and Nevis,0,0,0,0,0,0,0
2012,KOR,South Korea,43,43,0,0,0,0,86
2012,KWT,Kuwait,0,0,0,0,0,1288,1288
2012,LAO,Laos,160023,292657,225542,1926,0,0,680148
2012,LBN,Lebanon,0,0,85,0,0,0,85
2012,LBR,Liberia,41471,10129,923,235,128,0,52886
2012,LBY,Libya,0,0,0,0,0,258,258
2012,LCA,Saint Lucia,0,0,0,0,0,0,0
2012,LIE,Liechtenstein,0,0,0,0,0,0,0
2012,LKA,Sri Lanka,51126,4807,3669,1266,0,0,60868
2012,LSO,Lesotho,1265,2445,46731,0,0,0,50441
2012,LTU,Lithuania,129,0,0,0,0,0,129
2012,LUX,Luxembourg,0,0,0,0,0,0,0
2012,LVA,Latvia,407,236,43,0,0,0,686
2012,MAC,Macao,0,0,0,0,0,0,0
2012,MAR,Morocco,1673,8887,2875,129,43,106,13713
2012,MDA,Moldova,9550,386,43,42,278,0,10299
2012,MDG,Madagascar,174923,1300702,2860154,17040,362,6372,4359553
2012,MEX,Mexico,301995,858492,221955,8253,917,6071,1397683
2012,MKD,Macedonia,4546,10346,4162,0,0,21,19075
2012,MLI,Mali,2567790,501247,2753491,11398,85,319,5834330
2012,MLT,Malta,0,0,0,0,0,0,0
2012,MMR,Myanmar,819629,2347356,544028,10620,21,0,3721654
2012,MNE,Montenegro,3753,18954,6352,43,0,42,29144
2012,MNG,Mongolia,576961,166167,1460555,9745,0,1373,2214801
2012,MNP,Northern Mariana Islands,0,0,0,0,0,0,0
2012,MOZ,Mozambique,1783299,13393728,4840382,582255,535,120289,20720488
2012,MRT,Mauritania,35116,6332,236702,3368,107,1223,282848
2012,MSR,Montserrat,0,0,0,0,0,0,0
2012,MTQ,Martinique,0,0,0,0,0,0,0
2012,MUS,Mauritius,1115,42,0,0,0,0,1157
2012,MWI,Malawi,195115,309591,108373,39660,170,1266,654175
2012,MYS,Malaysia,11651,9054,344,491,21,0,21561
2012,MYT,Mayotte,0,0,0,0,0,0,0
2012,NAM,Namibia,373161,1686720,6732234,20242,727,11696,8824780
2012,NCL,New Caledonia,0,0,0,0,0,0,0
2012,NER,Niger,56775,0,122699,29793,0,0,209267
2012,NGA,Nigeria,2954147,1735296,1455937,62248,2465,107,6210200
2012,NIC,Nicaragua,43701,29577,31745,4655,450,21,110149
2012,NLD,Netherlands,21,0,0,0,0,0,21
2012,NOR,Norway,0,0,0,0,0,0,0
2012,NPL,Nepal,20823,188661,3410,86,0,85,213065
2012,NRU,Nauru,0,0,0,0,0,0,0
2012,NZL,New Zealand,43,257,43,85,0,21,449
2012,OMN,Oman,0,0,0,0,0,0,0
2012,PAK,Pakistan,193128,9531,6284,5515,85,621,215164
2012,PAN,Panama,21098,4420,2597,317,0,64,28496
2012,PER,Peru,24076,80643,20455,321,21,1262,126778
2012,PHL,Philippines,54088,2548,7018,320,84,0,64058
2012,PLW,Palau,0,0,0,0,0,0,0
2012,PNG,Papua New Guinea,99109,17659,24726,2226,428,0,144148
2012,POL,Poland,4031,709,708,214,322,0,5984
2012,PRI,Puerto Rico,149,385,2253,64,0,21,2872
2012,PRK,North Korea,4273,6332,1071,128,0,43,11847
2012,PRT,Portugal,14637,55829,18394,364,171,21,89416
2012,PRY,Paraguay,294374,516615,428367,423188,64,128,1662736
2012,PSE,Palestina,0,0,0,0,0,0,0
2012,PYF,French Polynesia,0,0,0,0,0,0,0
2012,QAT,Qatar,0,0,21,0,0,107,128
2012,REU,Reunion,0,43,0,0,0,0,43
2012,ROU,Romania,256187,4584,17893,26698,2313,85,307760
2012,RUS,Russia,2559807,9034344,2231165,757940,15357,60572,14659185
2012,RWA,Rwanda,3134,4593,21487,987,0,0,30201
2012,SAU,Saudi Arabia,5386,0,21,21,0,1309,6737
2012,SDN,Sudan,1880963,1437334,4865944,71607,491,1436,8257775
2012,SEN,Senegal,651205,1109764,1801153,17747,0,192,3580061
2012,SGP,Singapore,0,0,0,21,0,0,21
2012,SHN,Saint Helena,0,0,0,0,0,0,0
2012,SJM,Svalbard and Jan Mayen,0,0,0,0,0,0,0
2012,SLB,Solomon Islands,0,0,0,0,0,0,0
2012,SLE,Sierra Leone,537010,428867,57186,8350,879,0,1032292
2012,SLV,El Salvador,3154,2251,21,21,0,0,5447
2012,SMR,San Marino,0,0,0,0,0,0,0
2012,SOM,Somalia,6523,11313,42585,300,64,0,60785
2012,SPM,Saint Pierre and Miquelon,0,0,0,0,0,0,0
2012,SRB,Serbia,155281,8753,10408,687,85,0,175214
2012,SSD,South Sudan,737438,13263936,15635692,1144409,256,1008,30782739
2012,STP,São Tomé and Príncipe,0,0,0,0,0,0,0
2012,SUR,Suriname,1158,6247,30654,105,85,0,38249
2012,SVK,Slovakia,2167,21,150,0,256,0,2594
2012,SVN,Slovenia,64,772,43,0,0,0,879
2012,SWE,Sweden,0,0,0,0,0,0,0
2012,SWZ,Swaziland,22108,26640,35892,106,42,1310,86098
2012,SYC,Seychelles,0,0,0,0,0,0,0
2012,SYR,Syria,13738,12578,21,64,21,150,26572
2012,TCA,Turks and Caicos Islands,0,0,0,0,0,0,0
2012,TCD,Chad,2382275,1575074,5883686,120315,1287,177994,10140631
2012,TGO,Togo,235351,401627,143522,408,21,0,780929
2012,THA,Thailand,998886,563164,92841,8551,318,0,1663760
2012,TJK,Tajikistan,687,0,751,43,0,236,1717
2012,TKL,Tokelau,0,0,0,0,0,0,0
2012,TKM,Turkmenistan,47416,0,34322,192,0,12856,94786
2012,TLS,Timor-Leste,9402,1563,0,0,0,0,10965
2012,TON,Tonga,0,0,0,0,0,0,0
2012,TTO,Trinidad and Tobago,0,0,0,0,0,0,0
2012,TUN,Tunisia,5045,2768,322,0,0,1694,9829
2012,TUR,Turkey,267710,5901,3470,728,836,1025,279670
2012,TUV,Tuvalu,0,0,0,0,0,0,0
2012,TWN,Taiwan,0,0,0,0,0,0,0
2012,TZA,Tanzania,1127101,8834913,3345541,1253598,342,3964,14565459
2012,UGA,Uganda,826097,1255270,1435456,4601,361,0,3521785
2012,UKR,Ukraine,560794,69173,19092,6882,24077,43,680061
2012,UMI,United States Minor Outlying Islands,0,0,0,0,0,0,0
2012,URY,Uruguay,18692,4439,9053,1372,128,0,33684
2012,USA,United States,608778,1332912,1668587,68029,574,27059,3705939
2012,UZB,Uzbekistan,41987,0,24043,472,21,6161,72684
2012,VCT,Saint Vincent and the Grenadines,0,0,0,0,0,0,0
2012,VEN,Venezuela,133960,111613,1308809,225728,448,42,1780600
2012,VGB,British Virgin Islands,0,0,0,0,0,0,0
2012,VIR,"Virgin Islands, U.S.",0,0,0,0,0,0,0
2012,VNM,Vietnam,727177,302308,86859,8387,681,0,1125412
2012,VUT,Vanuatu,0,0,0,0,0,0,0
2012,WLF,Wallis and Futuna,0,0,0,0,0,0,0
2012,WSM,Samoa,0,0,0,0,0,0,0
2012,XAD,Akrotiri and Dhekelia,0,0,0,0,0,0,0
2012,XKO,Kosovo,3390,5796,835,0,21,149,10191
2012,XNC,Northern Cyprus,64,0,107,0,0,21,192
2012,YEM,Yemen,0,0,43,64,0,85,192
2012,ZAF,South Africa,544652,331040,3225503,19507,3645,7849,4132196
2012,ZMB,Zambia,3297864,15482430,4716090,605227,1260,0,24102871
2012,ZWE,Zimbabwe,807500,1305744,1644561,8495,298,964,3767562
2013,AFG,Afghanistan,1996,172,1887,214,0,3283,7552
2013,AGO,Angola,997107,21143834,15272259,113099,2033,1072,37529404
2013,ALA,Åland,0,0,0,0,0,0,0
2013,ALB,Albania,944,193,21,0,0,0,1158
2013,AND,Andorra,0,0,0,0,0,0,0
2013,ARE,United Arab Emirates,0,0,0,0,0,880,880
2013,ARG,Argentina,856332,740285,1009123,347992,1564,5169,2960465
2013,ARM,Armenia,11416,1202,1780,85,0,0,14483
2013,ASM,American Samoa,0,0,0,0,0,0,0
2013,ATF,French Southern Territories,0,0,0,0,0,0,0
2013,ATG,Antigua and Barbuda,0,0,0,0,0,0,0
2013,AUS,Australia,410530,4035860,23628924,229317,878,252175,28557684
2013,AUT,Austria,107,172,0,0,0,0,279
2013,AZE,Azerbaijan,87020,1501,9187,85,0,235,98028
2013,BDI,Burundi,5428,12212,18546,21,0,0,36207
2013,BEL,Belgium,0,0,0,0,0,0,0
2013,BEN,Benin,370820,692766,878511,429,343,0,1942869
2013,BES,"Bonaire, Sint Eustatius and Saba",0,0,0,0,0,0,0
2013,BFA,Burkina Faso,893710,280175,1137987,1327,0,0,2313199
2013,BGD,Bangladesh,8994,57850,55831,128,0,0,122803
2013,BGR,Bulgaria,62012,1672,63,255,21,0,64023
2013,BHR,Bahrain,0,0,0,0,0,0,0
2013,BHS,Bahamas,600,37113,1825,965,107,21,40631
2013,BIH,Bosnia and Herzegovina,729,1116,944,0,0,0,2789
2013,BLR,Belarus,6932,4119,170,42,472,0,11735
2013,BLZ,Belize,15433,40914,10882,3306,43,21,70599
2013,BMU,Bermuda,0,0,0,0,0,0,0
2013,BOL,Bolivia,219872,611302,649188,275165,170,127,1755824
2013,BRA,Brazil,2678705,1578756,5036957,470191,6232,4206,9775047
2013,BRB,Barbados,0,0,0,0,0,0,0
2013,BRN,Brunei,0,0,0,0,0,0,0
2013,BTN,Bhutan,214,3112,128,0,0,0,3454
2013,BWA,Botswana,234789,268966,3498891,59524,0,1673,4063843
2013,CAF,Central African Republic,344137,15272150,2803402,9656,234,105,18429684
2013,CAN,Canada,47246,3059444,429144,319389,42,16698,3871963
2013,CHE,Switzerland,0,0,0,0,0,0,0
2013,CHL,Chile,7016,11719,11693,150,0,1178,31756
2013,CHN,China,3028454,216910,148684,19629,34015,663,3448355
2013,CIV,Côte d'Ivoire,298654,2389170,318273,4010,621,0,3010728
2013,CMR,Cameroon,426289,2077895,505367,46064,600,21,3056236
2013,COD,Democratic Republic of the Congo,2949726,25666821,3604455,1607034,7999,1564,33837599
2013,COG,Republic of Congo,395852,2091483,1162651,30135,170,0,3680291
2013,COL,Colombia,33133,101823,1430776,159400,106,0,1725238
2013,COM,Comoros,751,193,21,0,0,0,965
2013,CPV,Cape Verde,0,0,0,0,0,0,0
2013,CRI,Costa Rica,31833,23334,1094,365,128,0,56754
2013,CUB,Cuba,98076,28887,19871,1798,0,21,148653
2013,CYM,Cayman Islands,0,0,0,0,0,0,0
2013,CYP,Cyprus,837,279,836,0,21,64,2037
2013,CZE,Czech Republic,86,236,0,0,0,0,322
2013,DEU,Germany,729,43,0,0,0,0,772
2013,DJI,Djibouti,0,0,0,0,0,0,0
2013,DMA,Dominica,0,0,0,0,0,0,0
2013,DNK,Denmark,1266,0,0,0,0,0,1266
2013,DOM,Dominican Republic,14699,8046,2422,1653,21,0,26841
2013,DZA,Algeria,12169,14569,4786,192,0,2508,34224
2013,ECU,Ecuador,15088,6523,6396,2855,0,0,30862
2013,EGY,Egypt,101405,0,0,192,4121,0,105718
2013,ERI,Eritrea,4466,236,6288,43,42,214,11289
2013,ESH,Western Sahara,0,0,0,0,0,0,0
2013,ESP,Spain,46639,20540,7574,428,300,64,75545
2013,EST,Estonia,537,386,236,0,0,0,1159
2013,ETH,Ethiopia,377479,3347815,2120634,33011,84,12749,5891772
2013,FIN,Finland,816,301,0,150,0,0,1267
2013,FJI,Fiji,408,0,0,0,0,0,408
2013,FRA,France,8521,1008,1180,106,0,0,10815
2013,FRO,Faroe Islands,0,0,0,0,0,0,0
2013,FSM,Micronesia,0,0,0,0,0,0,0
2013,GAB,Gabon,29405,181511,260723,1136,21,0,472796
2013,GBR,United Kingdom,0,0,0,0,0,0,0
2013,GEO,Georgia,4873,793,1415,0,21,85,7187
2013,GGY,Guernsey,0,0,0,0,0,0,0
2013,GHA,Ghana,1225762,3844858,1486250,18933,533,64,6576400
2013,GIN,Guinea,533814,3316196,482252,23650,493,42,4356447
2013,GLP,Guadeloupe,0,0,0,0,0,0,0
2013,GMB,Gambia,147064,34685,25947,3604,42,150,211492
2013,GNB,Guinea-Bissau,23267,293805,8002,8239,42,0,333355
2013,GNQ,Equatorial Guinea,0,21,0,0,0,0,21
2013,GRC,Greece,56862,1717,10196,171,235,42,69223
2013,GRD,Grenada,0,0,0,0,0,0,0
2013,GRL,Greenland,0,0,0,0,0,0,0
2013,GTM,Guatemala,205168,115280,23544,1028,514,149,345683
2013,GUF,French Guiana,0,43,0,64,0,0,107
2013,GUM,Guam,0,0,0,0,0,0,0
2013,GUY,Guyana,15991,18177,37843,1243,214,0,73468
2013,HKG,Hong Kong,644,236,0,21,21,0,922
2013,HND,Honduras,49242,140406,81009,1865,63,0,272585
2013,HRV,Croatia,300,21,408,0,0,0,729
2013,HTI,Haiti,386,0,1416,493,0,0,2295
2013,HUN,Hungary,2210,279,86,0,0,0,2575
2013,IDN,Indonesia,327691,124989,121236,3663,1820,0,579399
2013,IMN,Isle of Man,0,0,0,0,0,0,0
2013,IND,India,3317887,1144808,118050,5381,23822,106,4610054
2013,IRL,Ireland,0,0,0,0,0,0,0
2013,IRN,Iran,159722,148,12035,2036,1005,43268,218214
2013,IRQ,Iraq,50676,21,4889,298,257,35601,91742
2013,ISL,Iceland,0,0,0,0,0,0,0
2013,ISR,Israel,5475,966,858,0,0,944,8243
2013,ITA,Italy,31551,1545,3926,21,256,42,37341
2013,JAM,Jamaica,1608,491,193,0,21,0,2313
2013,JEY,Jersey,0,0,0,0,0,0,0
2013,JOR,Jordan,21,0,0,0,0,0,21
2013,JPN,Japan,9403,2102,751,85,2533,0,14874
2013,KAZ,Kazakhstan,483027,13733,656959,89551,663,18006,1261939
2013,KEN,Kenya,69283,45310,178634,8241,0,1544,303012
2013,KGZ,Kyrgyzstan,1478,193,2381,0,0,3497,7549
2013,KHM,Cambodia,593289,1887699,61841,78111,0,0,2620940
2013,KNA,Saint Kitts and Nevis,0,0,0,0,0,0,0
2013,KOR,South Korea,1564,1374,85,21,21,0,3065
2013,KWT,Kuwait,0,0,0,0,0,63,63
2013,LAO,Laos,212210,343467,296611,4783,0,0,857071
2013,LBN,Lebanon,386,21,0,0,0,0,407
2013,LBR,Liberia,24640,8216,214,21,107,0,33198
2013,LBY,Libya,1503,3412,258,0,0,451,5624
2013,LCA,Saint Lucia,0,0,0,0,0,0,0
2013,LIE,Liechtenstein,0,0,0,0,0,0,0
2013,LKA,Sri Lanka,23139,127,704,708,0,0,24678
2013,LSO,Lesotho,2168,3645,37007,0,0,0,42820
2013,LTU,Lithuania,0,0,0,0,0,0,0
2013,LUX,Luxembourg,0,0,0,0,0,0,0
2013,LVA,Latvia,966,730,0,86,43,0,1825
2013,MAC,Macao,0,0,0,0,0,0,0
2013,MAR,Morocco,857,1695,623,0,0,472,3647
2013,MDA,Moldova,34361,1629,214,85,942,0,37231
2013,MDG,Madagascar,134436,1464441,2406192,41789,429,8114,4055401
2013,MEX,Mexico,493779,938074,283873,14308,1345,3560,1734939
2013,MKD,Macedonia,4872,1758,1200,0,0,0,7830
2013,MLI,Mali,2977054,598895,2876276,17751,84,643,6470703
2013,MLT,Malta,0,0,0,0,0,0,0
2013,MMR,Myanmar,760513,1817858,404570,8690,0,0,2991631
2013,MNE,Montenegro,107,751,0,0,0,0,858
2013,MNG,Mongolia,71072,1137,876705,1245,0,214,950373
2013,MNP,Northern Mariana Islands,0,0,0,0,0,0,0
2013,MOZ,Mozambique,1855295,13268095,5330383,548661,491,128126,21131051
2013,MRT,Mauritania,33548,2383,231939,2509,107,1137,271623
2013,MSR,Montserrat,0,0,0,0,0,0,0
2013,MTQ,Martinique,0,0,0,0,0,0,0
2013,MUS,Mauritius,1545,0,0,0,0,0,1545
2013,MWI,Malawi,158045,225275,89123,30026,234,43,502746
2013,MYS,Malaysia,23936,7145,106,341,322,0,31850
2013,MYT,Mayotte,0,21,0,0,0,0,21
2013,NAM,Namibia,249579,635301,2804575,20754,171,1115,3711495
2013,NCL,New Caledonia,0,129,580,0,0,0,709
2013,NER,Niger,62098,21,183252,5451,0,21,250843
2013,NGA,Nigeria,2526736,2222402,1264136,63380,1067,471,6078192
2013,NIC,Nicaragua,70875,104878,65187,5790,343,0,247073
2013,NLD,Netherlands,0,0,0,0,0,0,0
2013,NOR,Norway,0,0,0,0,0,0,0
2013,NPL,Nepal,17814,199633,1585,235,0,0,219267
2013,NRU,Nauru,0,0,0,0,0,0,0
2013,NZL,New Zealand,1696,342,1439,21,86,64,3648
2013,OMN,Oman,0,0,0,0,0,0,0
2013,PAK,Pakistan,272272,729,1629,2745,127,255,277757
2013,PAN,Panama,21144,2980,1630,171,43,0,25968
2013,PER,Peru,7382,33439,27967,618,43,6674,76123
2013,PHL,Philippines,54561,6673,5601,385,21,0,67241
2013,PLW,Palau,0,0,0,0,0,0,0
2013,PNG,Papua New Guinea,120956,11820,30068,3754,1285,0,167883
2013,POL,Poland,2940,428,214,42,408,0,4032
2013,PRI,Puerto Rico,794,150,2383,0,0,0,3327
2013,PRK,North Korea,5448,9763,664,63,128,129,16195
2013,PRT,Portugal,69351,103698,7574,212,212,64,181111
2013,PRY,Paraguay,655839,684630,707831,406968,128,0,2455396
2013,PSE,Palestina,0,0,0,0,0,0,0
2013,PYF,French Polynesia,0,0,0,0,0,0,0
2013,QAT,Qatar,0,0,537,0,472,1180,2189
2013,REU,Reunion,0,0,0,0,0,0,0
2013,ROU,Romania,117180,2315,1477,5215,343,0,126530
2013,RUS,Russia,1237683,4530113,813951,214785,14156,37858,6848546
2013,RWA,Rwanda,2596,6828,25092,2724,0,0,37240
2013,SAU,Saudi Arabia,13695,0,214,0,21,2210,16140
2013,SDN,Sudan,2145280,1297740,3971117,53124,340,1672,7469273
2013,SEN,Senegal,659858,1429625,2211604,10216,0,0,4311303
2013,SGP,Singapore,0,0,0,0,0,0,0
2013,SHN,Saint Helena,0,0,0,0,0,0,0
2013,SJM,Svalbard and Jan Mayen,0,0,0,0,0,0,0
2013,SLB,Solomon Islands,0,0,0,0,0,0,0
2013,SLE,Sierra Leone,339395,426376,39946,6243,577,0,812537
2013,SLV,El Salvador,9188,17920,0,278,43,0,27429
2013,SMR,San Marino,0,0,0,0,0,0,0
2013,SOM,Somalia,4935,14725,52483,43,0,86,72272
2013,SPM,Saint Pierre and Miquelon,0,0,0,0,0,0,0
2013,SRB,Serbia,6631,21,170,0,0,0,6822
2013,SSD,South Sudan,696243,13318689,14093133,799510,149,705,28908429
2013,STP,São Tomé and Príncipe,0,0,0,0,0,0,0
2013,SUR,Suriname,663,9828,2296,192,0,0,12979
2013,SVK,Slovakia,816,0,0,0,85,0,901
2013,SVN,Slovenia,0,21,0,0,0,0,21
2013,SWE,Sweden,0,0,0,0,0,0,0
2013,SWZ,Swaziland,23055,32862,32114,86,21,901,89039
2013,SYC,Seychelles,0,0,0,0,0,0,0
2013,SYR,Syria,59759,3003,1138,278,493,9140,73811
2013,TCA,Turks and Caicos Islands,0,0,0,0,0,0,0
2013,TCD,Chad,2271361,1193691,5290645,59672,534,1050,8816953
2013,TGO,Togo,503202,406241,151354,1266,171,0,1062234
2013,THA,Thailand,857559,261548,69517,7519,575,0,1196718
2013,TJK,Tajikistan,6417,21,4013,107,0,86,10644
2013,TKL,Tokelau,0,0,0,0,0,0,0
2013,TKM,Turkmenistan,63558,0,27413,450,0,12471,103892
2013,TLS,Timor-Leste,556,64,85,0,0,0,705
2013,TON,Tonga,0,0,0,0,0,0,0
2013,TTO,Trinidad and Tobago,1523,21,64,0,0,0,1608
2013,TUN,Tunisia,2403,11140,772,43,0,149,14507
2013,TUR,Turkey,602608,8324,9396,1390,1177,2287,625182
2013,TUV,Tuvalu,0,0,0,0,0,0,0
2013,TWN,Taiwan,193,236,0,0,0,0,429
2013,TZA,Tanzania,765659,7808650,3093725,1125708,254,4802,12798798
2013,UGA,Uganda,665235,1064495,944419,10333,171,0,2684653
2013,UKR,Ukraine,630324,40641,8252,1410,16859,42,697528
2013,UMI,United States Minor Outlying Islands,0,0,0,0,0,0,0
2013,URY,Uruguay,8149,1585,5206,1179,193,0,16312
2013,USA,United States,606274,978040,477665,44031,1429,26350,2133789
2013,UZB,Uzbekistan,36294,494,9185,5278,21,4571,55843
2013,VCT,Saint Vincent and the Grenadines,0,0,0,0,0,0,0
2013,VEN,Venezuela,353961,258570,1707970,314408,963,149,2636021
2013,VGB,British Virgin Islands,0,0,0,0,0,0,0
2013,VIR,"Virgin Islands, U.S.",0,0,0,0,0,0,0
2013,VNM,Vietnam,884897,110535,43239,7465,1389,0,1047525
2013,VUT,Vanuatu,0,0,0,0,0,0,0
2013,WLF,Wallis and Futuna,0,0,0,0,0,0,0
2013,WSM,Samoa,0,0,0,0,0,0,0
2013,XAD,Akrotiri and Dhekelia,0,0,0,0,0,0,0
2013,XKO,Kosovo,1459,0,0,0,21,0,1480
2013,XNC,Northern Cyprus,0,86,0,0,0,0,86
2013,YEM,Yemen,64,0,0,0,0,0,64
2013,ZAF,South Africa,590461,291846,2977055,15238,3387,6267,3884254
2013,ZMB,Zambia,3241391,15691655,4623489,666061,1562,107,24224265
2013,ZWE,Zimbabwe,742885,890077,1244997,5753,405,900,2885017
2014,AFG,Afghanistan,923,0,472,21,0,215,1631
2014,AGO,Angola,866146,20669028,13722631,68423,1925,644,35328797
2014,ALA,Åland,0,0,0,0,0,0,0
2014,ALB,Albania,321,21,64,0,0,21,427
2014,AND,Andorra,0,0,0,0,0,0,0
2014,ARE,United Arab Emirates,0,0,0,21,0,0,21
2014,ARG,Argentina,458870,297659,1282819,291478,726,3623,2335175
2014,ARM,Armenia,5280,514,21,0,0,0,5815
2014,ASM,American Samoa,0,0,0,0,0,0,0
2014,ATF,French Southern Territories,0,0,0,0,0,0,0
2014,ATG,Antigua and Barbuda,0,0,0,0,0,0,0
2014,AUS,Australia,748234,4563856,41532161,237644,770,26227,47108892
2014,AUT,Austria,215,298,579,0,0,21,1113
2014,AZE,Azerbaijan,30952,2296,3648,0,0,107,37003
2014,BDI,Burundi,1586,8157,11420,85,0,0,21248
2014,BEL,Belgium,0,86,0,0,0,0,86
2014,BEN,Benin,251965,454622,935287,85,172,0,1642131
2014,BES,"Bonaire, Sint Eustatius and Saba",0,0,0,0,0,0,0
2014,BFA,Burkina Faso,822936,224228,1091344,2959,0,0,2141467
2014,BGD,Bangladesh,8068,55167,50959,1952,0,0,116146
2014,BGR,Bulgaria,36252,2489,85,171,215,43,39255
2014,BHR,Bahrain,0,0,0,0,0,0,0
2014,BHS,Bahamas,536,7836,365,706,0,0,9443
2014,BIH,Bosnia and Herzegovina,773,1524,965,0,0,0,3262
2014,BLR,Belarus,37113,22451,3860,2361,149,0,65934
2014,BLZ,Belize,6782,4528,2253,923,0,0,14486
2014,BMU,Bermuda,0,0,0,0,0,0,0
2014,BOL,Bolivia,251792,362365,356802,152277,192,128,1123556
2014,BRA,Brazil,3710634,2829084,8832744,497783,7179,2101,15879525
2014,BRB,Barbados,172,0,0,0,21,0,193
2014,BRN,Brunei,107,300,0,0,0,0,407
2014,BTN,Bhutan,1436,10601,278,0,0,0,12315
2014,BWA,Botswana,119351,222834,2514167,9874,214,1437,2867877
2014,CAF,Central African Republic,258380,14233583,2382817,8367,449,21,16883617
2014,CAN,Canada,77598,2586790,258981,219467,21,19406,3162263
2014,CHE,Switzerland,42,557,319,0,0,0,918
2014,CHL,Chile,25736,41600,48122,322,21,728,116529
2014,CHN,China,4810110,287144,203976,64494,58317,6006,5430047
2014,CIV,Côte d'Ivoire,118251,1193007,183680,877,641,0,1496456
2014,CMR,Cameroon,290517,1782779,361504,49606,235,0,2484641
2014,COD,Democratic Republic of the Congo,2646325,24824180,3362707,1447996,7760,470,32289438
2014,COG,Republic of Congo,280450,1764815,977227,11417,42,0,3033951
2014,COL,Colombia,76341,238989,1881454,247845,171,43,2444843
2014,COM,Comoros,150,579,213,0,0,0,942
2014,CPV,Cape Verde,0,0,0,0,0,0,0
2014,CRI,Costa Rica,24857,16916,601,321,85,0,42780
2014,CUB,Cuba,63129,22280,16288,2612,0,0,104309
2014,CYM,Cayman Islands,0,0,0,0,0,0,0
2014,CYP,Cyprus,558,0,0,0,0,0,558
2014,CZE,Czech Republic,0,643,150,0,0,0,793
2014,DEU,Germany,1589,900,42,0,171,0,2702
2014,DJI,Djibouti,0,0,0,21,0,150,171
2014,DMA,Dominica,0,0,0,0,0,0,0
2014,DNK,Denmark,0,0,0,0,0,0,0
2014,DOM,Dominican Republic,8777,6783,1757,1374,21,0,18712
2014,DZA,Algeria,17874,47567,47092,643,21,11804,125001
2014,ECU,Ecuador,9487,3775,2146,793,0,0,16201
2014,EGY,Egypt,69077,0,21,193,2641,0,71932
2014,ERI,Eritrea,8005,0,4464,150,21,451,13091
2014,ESH,Western Sahara,0,0,0,0,0,0,0
2014,ESP,Spain,15261,9786,7858,64,0,0,32969
2014,EST,Estonia,127,21,0,43,0,0,191
2014,ETH,Ethiopia,343666,3010134,1831104,29296,0,11566,5225766
2014,FIN,Finland,43,107,0,215,0,0,365
2014,FJI,Fiji,10025,1353,63,193,0,0,11634
2014,FRA,France,11267,7145,8821,21,21,64,27339
2014,FRO,Faroe Islands,0,0,0,0,0,0,0
2014,FSM,Micronesia,0,0,0,0,0,0,0
2014,GAB,Gabon,8563,130384,188558,21,0,0,327526
2014,GBR,United Kingdom,0,0,0,0,0,0,0
2014,GEO,Georgia,3778,214,987,0,0,0,4979
2014,GGY,Guernsey,0,0,0,0,0,0,0
2014,GHA,Ghana,1128974,3413307,1435296,11181,684,191,5989633
2014,GIN,Guinea,593680,2908456,493111,17405,234,0,4012886
2014,GLP,Guadeloupe,0,0,0,0,0,0,0
2014,GMB,Gambia,102691,29665,17946,3325,21,257,153905
2014,GNB,Guinea-Bissau,17536,391236,9763,9423,0,0,427958
2014,GNQ,Equatorial Guinea,0,64,0,0,0,0,64
2014,GRC,Greece,42179,579,6074,86,21,63,49002
2014,GRD,Grenada,0,0,0,0,0,0,0
2014,GRL,Greenland,0,0,0,0,0,0,0
2014,GTM,Guatemala,144441,41828,4957,812,279,43,192360
2014,GUF,French Guiana,43,535,343,364,0,0,1285
2014,GUM,Guam,0,0,0,0,0,0,0
2014,GUY,Guyana,27239,24595,43184,1222,1285,0,97525
2014,HKG,Hong Kong,86,172,0,0,0,0,258
2014,HND,Honduras,64524,176616,125510,1715,212,0,368577
2014,HRV,Croatia,172,537,472,0,0,0,1181
2014,HTI,Haiti,150,0,1309,85,0,0,1544
2014,HUN,Hungary,22835,1502,1801,385,965,0,27488
2014,IDN,Indonesia,1289471,536956,267779,18104,2937,0,2115247
2014,IMN,Isle of Man,0,0,0,0,0,0,0
2014,IND,India,3154917,1040963,151866,6212,21394,536,4375888
2014,IRL,Ireland,0,0,0,0,0,0,0
2014,IRN,Iran,132178,491,21055,2124,1005,57561,214414
2014,IRQ,Iraq,123577,363,6644,2725,361,42258,175928
2014,ISL,Iceland,0,0,0,0,0,0,0
2014,ISR,Israel,408,0,172,0,0,258,838
2014,ITA,Italy,96595,1114,7019,21,149,129,105027
2014,JAM,Jamaica,42,129,215,150,0,0,536
2014,JEY,Jersey,0,0,0,0,0,0,0
2014,JOR,Jordan,0,0,0,0,0,0,0
2014,JPN,Japan,10197,9681,2533,128,149,0,22688
2014,KAZ,Kazakhstan,1813647,24315,4301800,60227,791,18005,6218785
2014,KEN,Kenya,53355,35518,86608,13821,21,837,190160
2014,KGZ,Kyrgyzstan,559,278,2510,0,0,1953,5300
2014,KHM,Cambodia,481288,1853355,53957,7096,64,0,2395760
2014,KNA,Saint Kitts and Nevis,0,0,0,0,0,0,0
2014,KOR,South Korea,4143,6398,278,0,86,21,10926
2014,KWT,Kuwait,0,0,0,0,0,214,214
2014,LAO,Laos,127372,311900,182710,3343,0,0,625325
2014,LBN,Lebanon,0,0,0,0,0,0,0
2014,LBR,Liberia,94299,70622,85,278,42,0,165326
2014,LBY,Libya,85,0,43,0,0,1073,1201
2014,LCA,Saint Lucia,0,0,0,0,0,0,0
2014,LIE,Liechtenstein,0,0,0,0,0,0,0
2014,LKA,Sri Lanka,21315,4119,1954,1116,0,0,28504
2014,LSO,Lesotho,2231,2082,28269,408,0,0,32990
2014,LTU,Lithuania,84,0,0,21,0,0,105
2014,LUX,Luxembourg,0,0,0,0,0,0,0
2014,LVA,Latvia,665,42,0,407,0,0,1114
2014,MAC,Macao,0,0,0,0,0,0,0
2014,MAR,Morocco,600,708,3778,21,0,923,6030
2014,MDA,Moldova,68990,5164,321,42,854,0,75371
2014,MDG,Madagascar,122695,1072219,2144506,28374,212,4636,3372642
2014,MEX,Mexico,258264,166820,106182,5337,850,1286,538739
2014,MKD,Macedonia,279,21,0,0,0,21,321
2014,MLI,Mali,2654126,660247,2490083,11632,43,86,5816217
2014,MLT,Malta,0,0,0,0,0,0,0
2014,MMR,Myanmar,858246,2378735,518228,15708,42,0,3770959
2014,MNE,Montenegro,0,279,0,0,0,0,279
2014,MNG,Mongolia,193875,2296,1027590,600,21,770,1225152
2014,MNP,Northern Mariana Islands,0,0,0,0,0,0,0
2014,MOZ,Mozambique,1686104,13303385,5566053,441464,343,113143,21110492
2014,MRT,Mauritania,16807,0,17451,2017,0,129,36404
2014,MSR,Montserrat,0,0,0,0,0,0,0
2014,MTQ,Martinique,0,0,0,0,0,0,0
2014,MUS,Mauritius,1759,0,0,0,0,0,1759
2014,MWI,Malawi,123404,242298,74198,28737,150,193,468980
2014,MYS,Malaysia,69050,19076,1715,813,877,0,91531
2014,MYT,Mayotte,0,0,0,0,0,0,0
2014,NAM,Namibia,112694,621153,1886422,15799,406,321,2636795
2014,NCL,New Caledonia,43,107,0,0,0,0,150
2014,NER,Niger,52462,794,242821,6631,0,86,302794
2014,NGA,Nigeria,2536556,1801823,1371518,46892,1714,277,5758780
2014,NIC,Nicaragua,70385,139485,85258,8795,535,42,304500
2014,NLD,Netherlands,0,0,0,0,0,0,0
2014,NOR,Norway,0,0,0,0,0,0,0
2014,NPL,Nepal,27067,207832,2703,128,0,0,237730
2014,NRU,Nauru,0,0,0,0,0,0,0
2014,NZL,New Zealand,0,0,708,0,0,0,708
2014,OMN,Oman,43,0,0,0,0,42,85
2014,PAK,Pakistan,142064,3861,7703,1244,0,1996,156868
2014,PAN,Panama,18891,3670,964,212,42,0,23779
2014,PER,Peru,10385,34749,18496,256,128,2896,66910
2014,PHL,Philippines,94058,9326,10535,639,64,0,114622
2014,PLW,Palau,0,0,0,0,0,0,0
2014,PNG,Papua New Guinea,213413,49057,77186,4311,879,0,344846
2014,POL,Poland,1693,85,128,0,0,0,1906
2014,PRI,Puerto Rico,21,21,43,85,0,21,191
2014,PRK,North Korea,10065,85775,620,84,107,64,96715
2014,PRT,Portugal,4652,5942,986,0,42,0,11622
2014,PRY,Paraguay,299357,361634,383572,309881,147,21,1354612
2014,PSE,Palestina,0,0,0,0,0,0,0
2014,PYF,French Polynesia,0,0,0,0,0,0,0
2014,QAT,Qatar,0,0,86,0,0,85,171
2014,REU,Reunion,0,0,0,0,0,0,0
2014,ROU,Romania,143165,2206,1199,5043,385,0,151998
2014,RUS,Russia,4965223,7784638,3334313,262816,31685,28003,16406678
2014,RWA,Rwanda,1287,6653,17150,602,0,0,25692
2014,SAU,Saudi Arabia,8285,0,85,21,43,1739,10173
2014,SDN,Sudan,1427843,1067838,3823152,62676,749,4396,6386654
2014,SEN,Senegal,495534,1730063,1690241,6283,0,21,3922142
2014,SGP,Singapore,0,0,0,0,0,0,0
2014,SHN,Saint Helena,0,0,0,0,0,0,0
2014,SJM,Svalbard and Jan Mayen,0,0,0,0,0,0,0
2014,SLB,Solomon Islands,0,0,0,0,0,0,0
2014,SLE,Sierra Leone,584578,287556,46707,14917,385,0,934143
2014,SLV,El Salvador,5575,3474,21,21,0,0,9091
2014,SMR,San Marino,0,0,0,0,0,0,0
2014,SOM,Somalia,3862,2189,7234,257,64,171,13777
2014,SPM,Saint Pierre and Miquelon,0,0,0,0,0,0,0
2014,SRB,Serbia,3863,172,21,0,0,0,4056
2014,SSD,South Sudan,472050,15440626,13323860,663766,234,43,29900579
2014,STP,São Tomé and Príncipe,0,0,0,0,0,0,0
2014,SUR,Suriname,1632,8327,28936,107,21,0,39023
2014,SVK,Slovakia,2232,172,0,0,21,0,2425
2014,SVN,Slovenia,0,64,0,0,0,0,64
2014,SWE,Sweden,86,6869,3349,1695,0,0,11999
2014,SWZ,Swaziland,24193,26640,39046,42,257,858,91036
2014,SYC,Seychelles,0,0,0,0,0,0,0
2014,SYR,Syria,21376,772,107,171,42,1629,24097
2014,TCA,Turks and Caicos Islands,0,0,0,0,0,0,0
2014,TCD,Chad,1437698,1044851,5293887,95643,513,138540,8011132
2014,TGO,Togo,255639,342657,126241,535,277,0,725349
2014,THA,Thailand,795326,669735,86773,8654,319,0,1560807
2014,TJK,Tajikistan,4249,64,687,21,0,107,5128
2014,TKL,Tokelau,0,0,0,0,0,0,0
2014,TKM,Turkmenistan,160734,0,22193,922,644,9701,194194
2014,TLS,Timor-Leste,16976,2059,0,0,0,0,19035
2014,TON,Tonga,0,0,0,0,0,0,0
2014,TTO,Trinidad and Tobago,944,515,0,0,0,0,1459
2014,TUN,Tunisia,8134,11417,643,257,0,513,20964
2014,TUR,Turkey,372038,1604,4608,318,1111,1392,381071
2014,TUV,Tuvalu,0,0,0,0,0,0,0
2014,TWN,Taiwan,0,0,0,0,0,0,0
2014,TZA,Tanzania,599707,6968719,2671699,1095722,300,3857,11340004
2014,UGA,Uganda,541082,840893,736720,20469,383,0,2139547
2014,UKR,Ukraine,2677260,104849,70547,7819,41332,42,2901849
2014,UMI,United States Minor Outlying Islands,0,0,0,0,0,0,0
2014,URY,Uruguay,4527,771,3045,558,21,0,8922
2014,USA,United States,531746,666957,1143730,62453,2033,18025,2424944
2014,UZB,Uzbekistan,45290,43,24513,643,171,2060,72720
2014,VCT,Saint Vincent and the Grenadines,0,0,0,0,0,0,0
2014,VEN,Venezuela,434657,320246,1780141,332259,703,300,2868306
2014,VGB,British Virgin Islands,0,0,0,0,0,0,0
2014,VIR,"Virgin Islands, U.S.",0,0,0,0,0,0,0
2014,VNM,Vietnam,847760,245620,77472,9673,833,0,1181358
2014,VUT,Vanuatu,0,21,0,0,0,0,21
2014,WLF,Wallis and Futuna,0,0,0,0,0,0,0
2014,WSM,Samoa,0,0,0,0,0,0,0
2014,XAD,Akrotiri and Dhekelia,0,0,0,0,0,0,0
2014,XKO,Kosovo,472,21,0,0,0,0,493
2014,XNC,Northern Cyprus,0,0,0,0,0,0,0
2014,YEM,Yemen,43,0,0,21,0,106,170
2014,ZAF,South Africa,569941,355318,2978193,19982,6948,5748,3936130
2014,ZMB,Zambia,3000817,15277170,4525411,574164,1325,107,23378994
2014,ZWE,Zimbabwe,702451,919103,1509071,6907,382,256,3138170
2015,AFG,Afghanistan,1008,0,386,258,0,815,2467
2015,AGO,Angola,948245,21639889,14475740,119863,1927,1072,37186736
2015,ALA,Åland,0,0,0,0,0,0,0
2015,ALB,Albania,2124,2037,449,43,0,64,4717
2015,AND,Andorra,0,0,0,0,0,0,0
2015,ARE,United Arab Emirates,0,0,0,0,0,0,0
2015,ARG,Argentina,665856,439484,987550,306182,468,2359,2401899
2015,ARM,Armenia,6758,1159,1781,0,0,150,9848
2015,ASM,American Samoa,0,0,0,0,0,0,0
2015,ATF,French Southern Territories,0,0,0,0,0,0,0
2015,ATG,Antigua and Barbuda,0,0,0,0,0,0,0
2015,AUS,Australia,526252,4409390,37226427,268112,533,24467,42455181
2015,AUT,Austria,0,0,0,0,0,0,0
2015,AZE,Azerbaijan,281524,17942,68647,64,0,879,369056
2015,BDI,Burundi,7532,8732,19532,771,0,0,36567
2015,BEL,Belgium,0,0,0,0,0,0,0
2015,BEN,Benin,422577,503417,674692,471,427,43,1601627
2015,BES,"Bonaire, Sint Eustatius and Saba",0,0,0,0,0,0,0
2015,BFA,Burkina Faso,527694,174387,950335,3066,0,0,1655482
2015,BGD,Bangladesh,3541,10066,10925,21,0,0,24553
2015,BGR,Bulgaria,46107,1949,729,235,21,128,49169
2015,BHR,Bahrain,0,0,0,0,0,0,0
2015,BHS,Bahamas,257,13951,557,1159,0,0,15924
2015,BIH,Bosnia and Herzegovina,1482,2725,5002,322,0,0,9531
2015,BLR,Belarus,58709,24275,8176,1565,171,0,92896
2015,BLZ,Belize,8155,16975,6224,1715,0,0,33069
2015,BMU,Bermuda,0,0,0,0,0,0,0
2015,BOL,Bolivia,301377,843046,765364,434640,84,42,2344553
2015,BRA,Brazil,4214238,5255649,9917905,824166,10886,4674,20227518
2015,BRB,Barbados,0,0,0,0,0,0,0
2015,BRN,Brunei,171,343,0,0,21,0,535
2015,BTN,Bhutan,2038,9810,86,0,0,0,11934
2015,BWA,Botswana,75774,131220,1493552,178403,42,1867,1880858
2015,CAF,Central African Republic,364527,14616049,2947564,9975,448,127,17938690
2015,CAN,Canada,77812,2575450,180742,116793,21,18435,2969253
2015,CHE,Switzerland,0,0,0,0,0,0,0
2015,CHL,Chile,45119,132572,49304,364,107,601,228067
2015,CHN,China,3617789,214073,159717,55758,57603,18672,4123612
2015,CIV,Côte d'Ivoire,187719,1396718,186493,1691,789,0,1773410
2015,CMR,Cameroon,307368,1385808,365157,38444,150,64,2096991
2015,COD,Democratic Republic of the Congo,2764476,26222934,3650713,1563824,10527,1222,34213696
2015,COG,Republic of Congo,418002,2114428,1128072,34428,105,0,3695035
2015,COL,Colombia,52344,169701,1030162,165734,234,21,1418196
2015,COM,Comoros,579,729,21,0,0,0,1329
2015,CPV,Cape Verde,0,0,0,0,0,0,0
2015,CRI,Costa Rica,32347,16357,1630,429,64,0,50827
2015,CUB,Cuba,107435,47654,29746,5706,21,0,190562
2015,CYM,Cayman Islands,0,0,0,0,0,0,0
2015,CYP,Cyprus,301,0,21,0,0,0,322
2015,CZE,Czech Republic,2188,257,128,0,192,0,2765
2015,DEU,Germany,4120,128,0,21,42,0,4311
2015,DJI,Djibouti,0,0,0,0,0,0,0
2015,DMA,Dominica,0,0,0,0,0,0,0
2015,DNK,Denmark,1287,0,21,0,21,0,1329
2015,DOM,Dominican Republic,11154,14165,1906,685,0,0,27910
2015,DZA,Algeria,4978,12254,30265,279,0,3776,51552
2015,ECU,Ecuador,4678,8859,9680,5388,21,21,28647
2015,EGY,Egypt,41816,0,0,257,1309,708,44090
2015,ERI,Eritrea,13136,0,4980,64,42,257,18479
2015,ESH,Western Sahara,0,0,0,0,0,0,0
2015,ESP,Spain,32990,42198,9933,84,21,257,85483
2015,EST,Estonia,278,193,21,0,0,0,492
2015,ETH,Ethiopia,393336,3455509,2269112,33762,85,26938,6178742
2015,FIN,Finland,107,128,86,301,0,0,622
2015,FJI,Fiji,5301,2104,128,86,0,0,7619
2015,FRA,France,13757,2316,1330,128,107,0,17638
2015,FRO,Faroe Islands,0,0,0,0,0,0,0
2015,FSM,Micronesia,0,0,0,0,0,0,0
2015,GAB,Gabon,10943,154162,193966,42,0,0,359113
2015,GBR,United Kingdom,965,21,1867,687,0,0,3540
2015,GEO,Georgia,43833,1223,1845,0,43,21,46965
2015,GGY,Guernsey,0,0,0,0,0,0,0
2015,GHA,Ghana,1251075,3917885,1276360,22539,532,343,6468734
2015,GIN,Guinea,533231,2279759,405980,17234,425,0,3236629
2015,GLP,Guadeloupe,0,0,0,0,0,0,0
2015,GMB,Gambia,55358,28591,10495,2445,0,0,96889
2015,GNB,Guinea-Bissau,30263,441871,8819,14186,86,85,495310
2015,GNQ,Equatorial Guinea,0,0,0,0,0,0,0
2015,GRC,Greece,19856,1481,6590,106,171,344,28548
2015,GRD,Grenada,0,0,0,0,0,0,0
2015,GRL,Greenland,0,0,0,0,0,0,0
2015,GTM,Guatemala,167625,94101,20129,962,191,21,283029
2015,GUF,French Guiana,63,407,385,257,21,0,1133
2015,GUM,Guam,0,0,0,0,0,0,0
2015,GUY,Guyana,48508,54068,63470,7682,793,0,174521
2015,HKG,Hong Kong,0,0,0,0,0,0,0
2015,HND,Honduras,38550,100708,22966,1715,469,21,164429
2015,HRV,Croatia,1072,3326,1308,129,0,0,5835
2015,HTI,Haiti,150,128,1008,43,0,0,1329
2015,HUN,Hungary,3409,322,21,0,42,0,3794
2015,IDN,Indonesia,1387052,828132,350704,38995,2891,0,2607774
2015,IMN,Isle of Man,0,0,0,0,0,0,0
2015,IND,India,3044778,764330,86496,6497,29984,448,3932533
2015,IRL,Ireland,21,63,1287,3217,0,0,4588
2015,IRN,Iran,160669,578,19248,3091,448,43050,227084
2015,IRQ,Iraq,269650,4052,28546,8061,1156,50679,362144
2015,ISL,Iceland,0,0,0,0,0,0,0
2015,ISR,Israel,643,21,343,0,0,43,1050
2015,ITA,Italy,15197,1330,1995,85,128,64,18799
2015,JAM,Jamaica,641,964,86,0,0,0,1691
2015,JEY,Jersey,0,0,0,0,0,0,0
2015,JOR,Jordan,0,0,0,0,0,193,193
2015,JPN,Japan,6202,4057,1825,150,0,0,12234
2015,KAZ,Kazakhstan,1876846,23305,5336754,167323,469,13091,7417788
2015,KEN,Kenya,71538,70573,42819,8686,0,1653,195269
2015,KGZ,Kyrgyzstan,1051,21,900,150,0,193,2315
2015,KHM,Cambodia,726827,2519007,73058,77700,42,0,3396634
2015,KNA,Saint Kitts and Nevis,0,0,0,0,0,0,0
2015,KOR,South Korea,5516,944,43,21,0,0,6524
2015,KWT,Kuwait,0,0,0,0,0,0,0
2015,LAO,Laos,173114,313937,220349,6478,0,0,713878
2015,LBN,Lebanon,107,21,21,0,0,0,149
2015,LBR,Liberia,225688,187568,106,941,42,0,414345
2015,LBY,Libya,0,0,0,0,0,0,0
2015,LCA,Saint Lucia,0,0,0,0,0,0,0
2015,LIE,Liechtenstein,0,0,0,0,0,0,0
2015,LKA,Sri Lanka,26445,85,1288,644,0,0,28462
2015,LSO,Lesotho,2104,2832,43746,0,0,0,48682
2015,LTU,Lithuania,1028,64,0,0,21,0,1113
2015,LUX,Luxembourg,0,0,0,0,0,0,0
2015,LVA,Latvia,686,687,107,172,0,0,1652
2015,MAC,Macao,0,0,0,0,0,0,0
2015,MAR,Morocco,300,193,0,21,0,0,514
2015,MDA,Moldova,39045,750,85,107,42,0,40029
2015,MDG,Madagascar,162497,1267541,2096401,26227,319,7982,3560967
2015,MEX,Mexico,328610,419668,133829,10467,808,2123,895505
2015,MKD,Macedonia,3088,1630,835,0,0,21,5574
2015,MLI,Mali,2689523,397096,2404821,10987,42,472,5502941
2015,MLT,Malta,0,0,0,0,0,0,0
2015,MMR,Myanmar,955913,2503952,373227,9655,85,0,3842832
2015,MNE,Montenegro,5966,7707,558,21,0,0,14252
2015,MNG,Mongolia,247159,56797,1705677,4612,0,1757,2016002
2015,MNP,Northern Mariana Islands,0,0,0,0,0,0,0
2015,MOZ,Mozambique,1571274,13110729,5320914,574421,490,108701,20686529
2015,MRT,Mauritania,20348,1331,19875,3048,21,450,45073
2015,MSR,Montserrat,0,0,0,0,0,0,0
2015,MTQ,Martinique,0,0,0,0,0,0,0
2015,MUS,Mauritius,0,0,0,0,0,0,0
2015,MWI,Malawi,155212,250219,92424,9225,148,729,507957
2015,MYS,Malaysia,27860,9184,577,876,170,0,38667
2015,MYT,Mayotte,0,0,0,0,0,0,0
2015,NAM,Namibia,119778,507211,1806931,60898,214,320,2495352
2015,NCL,New Caledonia,1331,429,1051,42,0,0,2853
2015,NER,Niger,44346,85,142918,5816,0,85,193250
2015,NGA,Nigeria,3203045,1960432,1363139,134065,1904,172,6662757
2015,NIC,Nicaragua,52997,54753,13607,3454,429,0,125240
2015,NLD,Netherlands,0,0,0,0,0,0,0
2015,NOR,Norway,0,0,0,0,0,0,0
2015,NPL,Nepal,5386,28655,580,0,0,0,34621
2015,NRU,Nauru,0,0,0,0,0,0,0
2015,NZL,New Zealand,107,0,730,107,0,0,944
2015,OMN,Oman,0,0,0,0,0,0,0
2015,PAK,Pakistan,122936,364,2121,3799,128,300,129648
2015,PAN,Panama,48684,13758,4442,191,21,85,67181
2015,PER,Peru,13757,40097,23626,470,320,1541,79811
2015,PHL,Philippines,96856,14437,7620,574,64,0,119551
2015,PLW,Palau,0,0,0,0,0,0,0
2015,PNG,Papua New Guinea,395053,246548,92941,15773,2400,0,752715
2015,POL,Poland,3838,493,106,0,0,0,4437
2015,PRI,Puerto Rico,85,171,472,0,0,0,728
2015,PRK,North Korea,15796,39687,1200,535,0,193,57411
2015,PRT,Portugal,9718,32151,1972,21,85,0,43947
2015,PRY,Paraguay,249216,385945,405785,186939,21,42,1227948
2015,PSE,Palestina,407,0,343,0,0,193,943
2015,PYF,French Polynesia,0,0,0,0,0,0,0
2015,QAT,Qatar,0,0,193,0,494,1824,2511
2015,REU,Reunion,0,0,0,0,0,0,0
2015,ROU,Romania,99228,491,1327,5600,85,0,106731
2015,RUS,Russia,3089791,4190117,2082047,133583,13040,68812,9577390
2015,RWA,Rwanda,8609,7040,44865,5450,0,0,65964
2015,SAU,Saudi Arabia,8500,0,0,21,0,1953,10474
2015,SDN,Sudan,1575228,954924,3756568,74509,599,1006,6362834
2015,SEN,Senegal,303015,860047,1585641,11399,43,42,2760187
2015,SGP,Singapore,0,0,0,0,0,0,0
2015,SHN,Saint Helena,0,0,0,0,0,0,0
2015,SJM,Svalbard and Jan Mayen,0,0,0,0,0,0,0
2015,SLB,Solomon Islands,64,0,0,0,0,0,64
2015,SLE,Sierra Leone,856337,385077,45013,32389,405,0,1319221
2015,SLV,El Salvador,8345,16121,43,64,0,0,24573
2015,SMR,San Marino,0,0,0,0,0,0,0
2015,SOM,Somalia,298,1502,836,0,42,0,2678
2015,SPM,Saint Pierre and Miquelon,0,0,0,0,0,0,0
2015,SRB,Serbia,5342,193,150,0,0,0,5685
2015,SSD,South Sudan,647021,12454281,17649650,859121,213,193,31610479
2015,STP,São Tomé and Príncipe,0,0,0,0,0,0,0
2015,SUR,Suriname,1265,15776,19341,343,64,0,36789
2015,SVK,Slovakia,1459,21,0,0,0,0,1480
2015,SVN,Slovenia,0,0,0,0,0,0,0
2015,SWE,Sweden,494,0,0,0,0,0,494
2015,SWZ,Swaziland,18094,10452,19705,21,279,408,48959
2015,SYC,Seychelles,0,0,0,0,0,0,0
2015,SYR,Syria,113404,4377,2574,342,728,13394,134819
2015,TCA,Turks and Caicos Islands,0,0,0,0,0,0,0
2015,TCD,Chad,1209667,1119486,5468084,98760,214,36941,7933152
2015,TGO,Togo,712987,526579,134999,1565,386,0,1376516
2015,THA,Thailand,766396,596132,66995,4629,380,0,1434532
2015,TJK,Tajikistan,343,0,86,21,0,0,450
2015,TKL,Tokelau,0,0,0,0,0,0,0
2015,TKM,Turkmenistan,28100,64,70236,1351,0,26336,126087
2015,TLS,Timor-Leste,5409,986,43,21,0,0,6459
2015,TON,Tonga,0,0,0,0,0,0,0
2015,TTO,Trinidad and Tobago,816,214,43,0,0,0,1073
2015,TUN,Tunisia,363,5581,1095,0,21,729,7789
2015,TUR,Turkey,990508,4796,12542,2269,1582,3340,1015037
2015,TUV,Tuvalu,0,0,0,0,0,0,0
2015,TWN,Taiwan,236,64,43,0,0,0,343
2015,TZA,Tanzania,816943,8346462,2787858,1147304,212,3948,13102727
2015,UGA,Uganda,574155,949383,906028,16793,276,0,2446635
2015,UKR,Ukraine,2409927,133099,72672,7973,28419,64,2652154
2015,UMI,United States Minor Outlying Islands,0,0,0,0,0,0,0
2015,URY,Uruguay,18235,3296,9865,1756,0,0,33152
2015,USA,United States,1034044,1895910,1151135,53609,2890,9115,4146703
2015,UZB,Uzbekistan,18631,215,22066,471,236,1158,42777
2015,VCT,Saint Vincent and the Grenadines,0,0,0,0,0,0,0
2015,VEN,Venezuela,254849,231588,1622492,308525,577,171,2418202
2015,VGB,British Virgin Islands,0,0,0,0,0,0,0
2015,VIR,"Virgin Islands, U.S.",0,0,0,0,0,0,0
2015,VNM,Vietnam,1153754,243723,73164,14504,1903,0,1487048
2015,VUT,Vanuatu,21,858,0,0,0,0,879
2015,WLF,Wallis and Futuna,0,0,0,0,0,0,0
2015,WSM,Samoa,0,0,0,0,0,0,0
2015,XAD,Akrotiri and Dhekelia,0,0,0,0,0,0,0
2015,XKO,Kosovo,365,773,408,0,0,150,1696
2015,XNC,Northern Cyprus,0,0,0,0,0,0,0
2015,YEM,Yemen,0,0,0,0,0,0,0
2015,ZAF,South Africa,362620,229575,2178981,32018,8237,10385,2821816
2015,ZMB,Zambia,3084129,16474278,4559949,830496,1369,128,24950349
2015,ZWE,Zimbabwe,800310,1321346,1636576,7853,447,1285,3767817
2016,AFG,Afghanistan,2167,86,2036,300,0,128,4717
2016,AGO,Angola,1028338,21820540,13676745,137675,2007,1650,36666955
2016,ALA,Åland,0,0,0,0,0,0,0
2016,ALB,Albania,1890,665,107,107,0,21,2790
2016,AND,Andorra,0,0,0,0,0,0,0
2016,ARE,United Arab Emirates,0,0,0,0,0,86,86
2016,ARG,Argentina,751424,444697,1955966,265378,1456,5489,3424410
2016,ARM,Armenia,6160,1889,1158,0,0,21,9228
2016,ASM,American Samoa,0,0,0,0,0,0,0
2016,ATF,French Southern Territories,0,0,0,0,0,0,0
2016,ATG,Antigua and Barbuda,0,0,0,0,0,0,0
2016,AUS,Australia,501076,3140584,18984392,184415,749,9142,22820358
2016,AUT,Austria,0,85,0,0,0,0,85
2016,AZE,Azerbaijan,151437,986,7940,42,0,192,160597
2016,BDI,Burundi,6200,12684,17297,342,0,0,36523
2016,BEL,Belgium,0,0,107,0,0,0,107
2016,BEN,Benin,273109,554117,994616,857,128,42,1822869
2016,BES,"Bonaire, Sint Eustatius and Saba",0,0,0,0,0,0,0
2016,BFA,Burkina Faso,867689,306814,1165615,1628,43,0,2341789
2016,BGD,Bangladesh,965,3607,4358,214,0,0,9144
2016,BGR,Bulgaria,62332,2142,490,64,85,107,65220
2016,BHR,Bahrain,0,0,0,0,0,0,0
2016,BHS,Bahamas,278,20069,514,1694,0,0,22555
2016,BIH,Bosnia and Herzegovina,2489,2317,10817,21,0,0,15644
2016,BLR,Belarus,3925,3390,85,213,64,0,7677
2016,BLZ,Belize,7960,16310,4828,1050,21,21,30190
2016,BMU,Bermuda,0,0,0,0,0,0,0
2016,BOL,Bolivia,580089,1451113,1003461,493068,363,170,3528264
2016,BRA,Brazil,3557464,3913773,7335633,1145311,8703,2509,15963393
2016,BRB,Barbados,0,0,0,0,0,0,0
2016,BRN,Brunei,64,107,0,0,0,0,171
2016,BTN,Bhutan,172,4958,385,0,0,0,5515
2016,BWA,Botswana,98118,151097,1146002,75087,0,321,1470625
2016,CAF,Central African Republic,327261,17535851,3226637,11910,814,148,21102621
2016,CAN,Canada,53725,806966,56604,47393,322,6522,971532
2016,CHE,Switzerland,0,64,42,0,0,21,127
2016,CHL,Chile,22901,21524,37153,86,0,170,81834
2016,CHN,China,1123024,229056,139219,19078,19548,920,1530845
2016,CIV,Côte d'Ivoire,631246,2105755,318810,3198,1498,0,3060507
2016,CMR,Cameroon,318487,2028160,502252,48597,212,21,2897729
2016,COD,Democratic Republic of the Congo,3123621,25577801,3416869,1580499,10295,1350,33710435
2016,COG,Republic of Congo,408876,2120548,1107872,20690,106,0,3658092
2016,COL,Colombia,56166,219949,1549597,177089,537,0,2003338
2016,COM,Comoros,21,966,128,0,0,0,1115
2016,CPV,Cape Verde,0,0,0,0,0,0,0
2016,CRI,Costa Rica,26746,26918,771,192,43,0,54670
2016,CUB,Cuba,60382,20884,15876,3517,63,0,100722
2016,CYM,Cayman Islands,0,0,0,0,0,0,0
2016,CYP,Cyprus,0,2361,21,0,0,0,2382
2016,CZE,Czech Republic,1351,21,0,0,0,0,1372
2016,DEU,Germany,215,106,0,0,0,0,321
2016,DJI,Djibouti,0,0,129,0,0,451,580
2016,DMA,Dominica,0,0,0,0,0,0,0
2016,DNK,Denmark,0,0,0,0,0,0,0
2016,DOM,Dominican Republic,1433,171,172,107,0,0,1883
2016,DZA,Algeria,9417,26469,8241,192,0,3023,47342
2016,ECU,Ecuador,45826,18306,17986,3819,0,193,86130
2016,EGY,Egypt,61927,0,0,107,2123,9595,73752
2016,ERI,Eritrea,4573,64,1825,557,21,6825,13865
2016,ESH,Western Sahara,0,0,0,0,0,0,0
2016,ESP,Spain,36060,30676,8734,536,278,492,76776
2016,EST,Estonia,0,0,0,21,0,0,21
2016,ETH,Ethiopia,342186,3361490,2179598,27558,128,10666,5921626
2016,FIN,Finland,1846,258,0,21,0,0,2125
2016,FJI,Fiji,1567,235,21,21,0,0,1844
2016,FRA,France,15453,3303,5364,344,427,0,24891
2016,FRO,Faroe Islands,0,0,0,0,0,0,0
2016,FSM,Micronesia,0,0,0,0,0,0,0
2016,GAB,Gabon,18440,160175,224876,235,0,0,403726
2016,GBR,United Kingdom,21,64,365,193,21,0,664
2016,GEO,Georgia,26146,772,880,0,0,64,27862
2016,GGY,Guernsey,0,0,0,0,0,0,0
2016,GHA,Ghana,1616448,3165976,1428830,23095,985,128,6235462
2016,GIN,Guinea,737739,4696261,634958,22986,663,0,6092607
2016,GLP,Guadeloupe,0,0,0,0,0,0,0
2016,GMB,Gambia,153609,35399,26937,3732,21,107,219805
2016,GNB,Guinea-Bissau,19144,304577,11655,7983,0,21,343380
2016,GNQ,Equatorial Guinea,0,0,0,0,0,0,0
2016,GRC,Greece,34173,9014,11182,85,0,664,55118
2016,GRD,Grenada,0,0,0,43,0,0,43
2016,GRL,Greenland,0,0,0,0,0,0,0
2016,GTM,Guatemala,205640,132201,33034,1584,170,386,373015
2016,GUF,French Guiana,257,1910,665,342,86,0,3260
2016,GUM,Guam,0,0,0,0,0,0,0
2016,GUY,Guyana,17859,35111,23634,4719,256,0,81579
2016,HKG,Hong Kong,902,322,86,0,0,0,1310
2016,HND,Honduras,66541,158608,59371,2273,170,0,286963
2016,HRV,Croatia,836,901,2061,0,0,0,3798
2016,HTI,Haiti,43,0,1524,42,0,0,1609
2016,HUN,Hungary,213,0,0,0,0,0,213
2016,IDN,Indonesia,131706,58164,48982,4221,684,0,243757
2016,IMN,Isle of Man,0,0,0,0,0,0,0
2016,IND,India,3945528,1141937,83560,7545,33546,256,5212372
2016,IRL,Ireland,0,0,0,21,0,0,21
2016,IRN,Iran,181039,450,21994,3130,831,41698,249142
2016,IRQ,Iraq,211967,1995,11396,2014,1307,77079,305758
2016,ISL,Iceland,0,0,0,0,0,0,0
2016,ISR,Israel,1201,343,709,0,0,450,2703
2016,ITA,Italy,45315,2488,5106,170,127,214,53420
2016,JAM,Jamaica,666,107,0,0,0,0,773
2016,JEY,Jersey,0,0,0,0,0,0,0
2016,JOR,Jordan,0,0,0,0,0,622,622
2016,JPN,Japan,1974,1652,945,42,86,0,4699
2016,KAZ,Kazakhstan,775388,3840,1637347,21568,192,33549,2471884
2016,KEN,Kenya,76928,40691,82039,4979,0,1694,206331
2016,KGZ,Kyrgyzstan,5300,0,428,193,902,192,7015
2016,KHM,Cambodia,479264,1671632,83064,171783,0,0,2405743
2016,KNA,Saint Kitts and Nevis,0,0,0,0,0,0,0
2016,KOR,South Korea,2297,300,106,107,21,0,2831
2016,KWT,Kuwait,0,0,0,0,0,387,387
2016,LAO,Laos,195528,469045,349654,6996,0,0,1021223
2016,LBN,Lebanon,0,0,0,0,0,0,0
2016,LBR,Liberia,14589,11954,128,84,343,0,27098
2016,LBY,Libya,21,86,429,0,0,21,557
2016,LCA,Saint Lucia,0,0,0,0,0,0,0
2016,LIE,Liechtenstein,0,0,0,0,0,0,0
2016,LKA,Sri Lanka,25758,1866,2165,106,0,0,29895
2016,LSO,Lesotho,729,1888,65750,0,0,0,68367
2016,LTU,Lithuania,0,0,0,0,0,0,0
2016,LUX,Luxembourg,0,0,0,0,0,0,0
2016,LVA,Latvia,129,0,0,0,0,0,129
2016,MAC,Macao,0,0,0,0,0,0,0
2016,MAR,Morocco,1329,3520,579,0,0,63,5491
2016,MDA,Moldova,60183,426,215,127,213,0,61164
2016,MDG,Madagascar,178832,1698183,2898041,35805,791,12493,4824145
2016,MEX,Mexico,487225,645232,233608,9973,1752,1929,1379719
2016,MKD,Macedonia,3734,43,448,0,0,21,4246
2016,MLI,Mali,3737209,956431,3220697,22384,127,300,7937148
2016,MLT,Malta,0,0,0,0,0,0,0
2016,MMR,Myanmar,708199,1510318,286074,10730,86,0,2515407
2016,MNE,Montenegro,300,429,0,0,0,0,729
2016,MNG,Mongolia,169171,3756,936597,730,0,450,1110704
2016,MNP,Northern Mariana Islands,0,0,0,0,0,0,0
2016,MOZ,Mozambique,1414618,12407526,4072543,589239,171,105991,18590088
2016,MRT,Mauritania,88546,1072,71160,1951,0,149,162878
2016,MSR,Montserrat,0,0,0,0,0,0,0
2016,MTQ,Martinique,0,0,0,0,0,0,0
2016,MUS,Mauritius,0,0,0,0,0,0,0
2016,MWI,Malawi,142785,320420,92251,34407,149,128,590140
2016,MYS,Malaysia,33162,15841,1074,1029,322,0,51428
2016,MYT,Mayotte,0,0,0,0,0,0,0
2016,NAM,Namibia,93394,537891,1429862,33786,234,192,2095359
2016,NCL,New Caledonia,2125,193,687,86,0,0,3091
2016,NER,Niger,75968,149,230737,30822,0,0,337676
2016,NGA,Nigeria,4800628,2841152,1717299,150430,2248,171,9511928
2016,NIC,Nicaragua,64373,116410,41424,5579,170,42,227998
2016,NLD,Netherlands,0,0,0,0,0,0,0
2016,NOR,Norway,0,0,0,0,0,0,0
2016,NPL,Nepal,66778,516791,7169,471,0,43,591252
2016,NRU,Nauru,0,0,0,0,0,0,0
2016,NZL,New Zealand,3134,0,3842,0,0,0,6976
2016,OMN,Oman,0,0,0,0,0,258,258
2016,PAK,Pakistan,222641,14768,11095,1994,127,642,251267
2016,PAN,Panama,25713,15539,2380,492,21,193,44338
2016,PER,Peru,28630,88903,62675,641,813,4331,185993
2016,PHL,Philippines,92855,16307,5919,190,42,0,115313
2016,PLW,Palau,0,0,0,0,0,0,0
2016,PNG,Papua New Guinea,83992,6172,18069,1881,814,0,110928
2016,POL,Poland,966,0,0,0,0,0,966
2016,PRI,Puerto Rico,0,0,279,0,0,0,279
2016,PRK,North Korea,2167,3218,665,42,21,0,6113
2016,PRT,Portugal,33720,119567,6823,256,278,149,160793
2016,PRY,Paraguay,367767,678098,458654,309739,84,42,1814384
2016,PSE,Palestina,107,279,86,0,0,21,493
2016,PYF,French Polynesia,0,0,0,0,0,0,0
2016,QAT,Qatar,0,0,0,0,21,21,42
2016,REU,Reunion,0,0,0,0,0,0,0
2016,ROU,Romania,145343,725,749,1801,0,21,148639
2016,RUS,Russia,1547003,5634932,1808302,264593,11776,93646,9360252
2016,RWA,Rwanda,10067,7384,39990,5345,0,0,62786
2016,SAU,Saudi Arabia,6183,0,64,21,0,1739,8007
2016,SDN,Sudan,1544595,1316845,3987628,72230,556,900,6922754
2016,SEN,Senegal,520585,1627237,2291866,7917,21,85,4447711
2016,SGP,Singapore,0,0,0,0,0,0,0
2016,SHN,Saint Helena,0,0,0,0,0,0,0
2016,SJM,Svalbard and Jan Mayen,0,0,0,0,0,0,0
2016,SLB,Solomon Islands,0,0,0,0,0,0,0
2016,SLE,Sierra Leone,451234,555020,43275,6072,579,0,1056180
2016,SLV,El Salvador,2210,1029,64,21,43,0,3367
2016,SMR,San Marino,0,0,0,0,0,0,0
2016,SOM,Somalia,2253,279,1846,172,64,21,4635
2016,SPM,Saint Pierre and Miquelon,0,0,0,0,0,0,0
2016,SRB,Serbia,7426,236,343,0,0,0,8005
2016,SSD,South Sudan,629808,15911440,15634148,979332,836,106,33155670
2016,STP,São Tomé and Príncipe,0,0,0,0,0,0,0
2016,SUR,Suriname,772,5516,5345,258,42,0,11933
2016,SVK,Slovakia,600,0,0,0,64,0,664
2016,SVN,Slovenia,86,150,107,0,0,0,343
2016,SWE,Sweden,0,0,0,0,0,0,0
2016,SWZ,Swaziland,14724,7340,15431,214,21,193,37923
2016,SYC,Seychelles,0,0,0,0,0,0,0
2016,SYR,Syria,25285,1415,493,85,42,1971,29291
2016,TCA,Turks and Caicos Islands,0,0,0,0,0,0,0
2016,TCD,Chad,2077057,1706797,6251306,168781,535,108422,10312898
2016,TGO,Togo,392522,467612,196263,235,171,0,1056803
2016,THA,Thailand,677330,546791,158321,3611,276,0,1386329
2016,TJK,Tajikistan,1159,0,0,64,0,0,1223
2016,TKL,Tokelau,0,0,0,0,0,0,0
2016,TKM,Turkmenistan,31276,0,91788,193,43,15239,138539
2016,TLS,Timor-Leste,945,43,0,0,0,0,988
2016,TON,Tonga,0,0,0,0,0,0,0
2016,TTO,Trinidad and Tobago,2467,1331,0,0,21,0,3819
2016,TUN,Tunisia,814,4507,86,0,0,192,5599
2016,TUR,Turkey,784058,6349,10297,1818,1412,3727,807661
2016,TUV,Tuvalu,0,0,0,0,0,0,0
2016,TWN,Taiwan,0,21,0,43,0,0,64
2016,TZA,Tanzania,763625,7507571,3187032,1149573,406,3474,12611681
2016,UGA,Uganda,790237,1629388,1083645,14518,212,0,3518000
2016,UKR,Ukraine,1504415,13876,14652,2306,6816,85,1542150
2016,UMI,United States Minor Outlying Islands,0,0,0,0,0,0,0
2016,URY,Uruguay,8149,1648,6370,1051,0,0,17218
2016,USA,United States,730001,889188,1341260,37777,1433,16900,3016559
2016,UZB,Uzbekistan,21938,21,9659,3242,0,1030,35890
2016,VCT,Saint Vincent and the Grenadines,0,0,0,0,0,0,0
2016,VEN,Venezuela,277571,373783,1715185,294204,1373,107,2662223
2016,VGB,British Virgin Islands,0,0,0,0,0,0,0
2016,VIR,"Virgin Islands, U.S.",0,0,0,0,0,0,0
2016,VNM,Vietnam,901046,201425,50177,8791,1563,0,1163002
2016,VUT,Vanuatu,0,0,0,0,0,0,0
2016,WLF,Wallis and Futuna,0,0,0,0,0,0,0
2016,WSM,Samoa,0,0,0,0,0,0,0
2016,XAD,Akrotiri and Dhekelia,0,0,0,0,0,0,0
2016,XKO,Kosovo,0,0,0,0,0,0,0
2016,XNC,Northern Cyprus,0,0,0,0,0,0,0
2016,YEM,Yemen,0,0,0,301,0,1352,1653
2016,ZAF,South Africa,205708,162751,1254700,10080,964,5964,1640167
2016,ZMB,Zambia,2885353,15960598,4414240,866552,1648,42,24128433
2016,ZWE,Zimbabwe,535764,801083,935737,5880,363,963,2279790
2017,AFG,Afghanistan,364,450,64,128,0,0,1006
2017,AGO,Angola,889385,23635311,13326694,94424,1968,1050,37948832
2017,ALA,Åland,0,0,0,0,0,0,0
2017,ALB,Albania,14958,9101,2596,63,0,150,26868
2017,AND,Andorra,0,0,0,0,0,0,0
2017,ARE,United Arab Emirates,0,0,0,0,0,0,0
2017,ARG,Argentina,1051350,1297386,2808416,320657,2272,3433,5483514
2017,ARM,Armenia,18177,2253,3003,64,150,0,23647
2017,ASM,American Samoa,0,0,0,0,0,0,0
2017,ATF,French Southern Territories,0,0,0,0,0,0,0
2017,ATG,Antigua and Barbuda,0,0,0,0,0,0,0
2017,AUS,Australia,1413140,3527120,44203864,162837,788,44969,49352718
2017,AUT,Austria,150,192,236,0,85,21,684
2017,AZE,Azerbaijan,148306,7425,18930,85,150,944,175840
2017,BDI,Burundi,4014,9316,14339,815,21,0,28505
2017,BEL,Belgium,0,0,0,0,0,0,0
2017,BEN,Benin,252350,377669,866508,921,386,86,1497920
2017,BES,"Bonaire, Sint Eustatius and Saba",0,0,0,0,0,0,0
2017,BFA,Burkina Faso,660545,231806,1118069,4464,0,0,2014884
2017,BGD,Bangladesh,4033,1137,772,64,64,0,6070
2017,BGR,Bulgaria,73278,3302,235,686,171,63,77735
2017,BHR,Bahrain,0,0,0,0,0,0,0
2017,BHS,Bahamas,729,35998,1265,2080,128,0,40200
2017,BIH,Bosnia and Herzegovina,7168,17365,28915,258,21,0,53727
2017,BLR,Belarus,5772,128,450,0,0,0,6350
2017,BLZ,Belize,4357,25243,5153,1437,0,0,36190
2017,BMU,Bermuda,0,0,0,0,0,0,0
2017,BOL,Bolivia,343882,935550,816131,461299,234,129,2557225
2017,BRA,Brazil,4063422,5591158,9766470,1146756,10247,2404,20580457
2017,BRB,Barbados,0,0,0,0,0,0,0
2017,BRN,Brunei,0,0,0,0,0,0,0
2017,BTN,Bhutan,1395,4633,107,0,0,0,6135
2017,BWA,Botswana,183056,450525,4121042,82728,0,1867,4839218
2017,CAF,Central African Republic,323874,13864521,2994721,10233,642,127,17194118
2017,CAN,Canada,168163,2353024,257461,159404,149,6372,2944573
2017,CHE,Switzerland,0,21,0,0,0,42,63
2017,CHL,Chile,53039,309469,123574,880,234,535,487731
2017,CHN,China,3768246,137976,159826,60096,67289,12255,4205688
2017,CIV,Côte d'Ivoire,103525,1419644,176576,919,300,0,1700964
2017,CMR,Cameroon,313036,1674935,423029,49499,578,21,2461098
2017,COD,Democratic Republic of the Congo,2674531,26954903,3451126,1627253,4905,578,34713296
2017,COG,Republic of Congo,286631,2240302,1071445,17428,42,0,3615848
2017,COL,Colombia,20127,103841,1076682,114254,107,0,1315011
2017,COM,Comoros,0,21,0,0,0,0,21
2017,CPV,Cape Verde,0,0,0,0,0,0,0
2017,CRI,Costa Rica,19661,12663,558,191,21,0,33094
2017,CUB,Cuba,101359,43636,26979,4441,171,0,176586
2017,CYM,Cayman Islands,0,0,0,0,0,0,0
2017,CYP,Cyprus,0,0,0,0,0,0,0
2017,CZE,Czech Republic,4121,364,0,64,21,0,4570
2017,DEU,Germany,1137,1544,301,0,64,0,3046
2017,DJI,Djibouti,0,0,0,0,0,21,21
2017,DMA,Dominica,0,0,0,0,0,0,0
2017,DNK,Denmark,0,0,0,0,0,0,0
2017,DOM,Dominican Republic,2230,602,0,300,0,0,3132
2017,DZA,Algeria,16052,99473,8948,728,0,6054,131255
2017,ECU,Ecuador,8069,3152,4247,1932,0,214,17614
2017,EGY,Egypt,30244,0,42,63,728,9252,40329
2017,ERI,Eritrea,1353,0,987,172,0,64,2576
2017,ESH,Western Sahara,0,0,0,0,0,0,0
2017,ESP,Spain,31360,91221,16502,1373,42,300,140798
2017,EST,Estonia,386,42,0,0,0,0,428
2017,ETH,Ethiopia,388700,2844479,1625781,33527,212,2939,4895638
2017,FIN,Finland,0,0,0,0,0,0,0
2017,FJI,Fiji,1502,365,150,279,0,0,2296
2017,FRA,France,14549,21288,16977,106,64,150,53134
2017,FRO,Faroe Islands,0,0,0,0,0,0,0
2017,FSM,Micronesia,0,0,0,0,0,0,0
2017,GAB,Gabon,15968,195918,248982,556,0,0,461424
2017,GBR,United Kingdom,0,21,730,129,0,0,880
2017,GEO,Georgia,18675,1800,856,0,21,21,21373
2017,GGY,Guernsey,0,0,0,0,0,0,0
2017,GHA,Ghana,1260149,3272255,1561297,18374,255,148,6112478
2017,GIN,Guinea,645581,3202919,516725,23911,405,64,4389605
2017,GLP,Guadeloupe,0,0,0,0,0,0,0
2017,GMB,Gambia,134844,39603,23073,5022,0,321,202863
2017,GNB,Guinea-Bissau,16142,327997,11374,7746,0,0,363259
2017,GNQ,Equatorial Guinea,0,43,0,0,0,0,43
2017,GRC,Greece,23355,4765,11697,107,85,234,40243
2017,GRD,Grenada,0,0,0,0,0,0,0
2017,GRL,Greenland,0,0,1996,579,0,0,2575
2017,GTM,Guatemala,173980,116340,18368,1070,298,128,310184
2017,GUF,French Guiana,0,42,21,0,0,0,63
2017,GUM,Guam,0,0,0,0,0,0,0
2017,GUY,Guyana,12063,17448,54562,2210,986,0,87269
2017,HKG,Hong Kong,0,0,0,0,0,0,0
2017,HND,Honduras,35029,71388,27477,1436,255,0,135585
2017,HRV,Croatia,13650,17472,20586,278,128,42,52156
2017,HTI,Haiti,64,0,987,0,0,0,1051
2017,HUN,Hungary,2145,193,214,537,0,0,3089
2017,IDN,Indonesia,78177,22643,59181,1946,1134,0,163081
2017,IMN,Isle of Man,0,0,0,0,0,0,0
2017,IND,India,3481735,1622019,80619,10018,17017,214,5211622
2017,IRL,Ireland,0,364,128,3456,21,0,3969
2017,IRN,Iran,180198,2079,18475,2511,1777,34658,239698
2017,IRQ,Iraq,100801,514,4762,1176,320,40113,147686
2017,ISL,Iceland,0,0,0,0,0,0,0
2017,ISR,Israel,944,193,279,0,0,64,1480
2017,ITA,Italy,64031,31490,25072,149,277,684,121703
2017,JAM,Jamaica,1459,0,129,0,0,0,1588
2017,JEY,Jersey,0,0,0,0,0,0,0
2017,JOR,Jordan,21,0,43,0,0,602,666
2017,JPN,Japan,4099,3606,623,64,192,0,8584
2017,KAZ,Kazakhstan,2672991,13180,11546294,30666,1454,77248,14341833
2017,KEN,Kenya,11496,13021,24877,2596,0,493,52483
2017,KGZ,Kyrgyzstan,2296,451,793,42,0,85,3667
2017,KHM,Cambodia,461102,2204132,43808,8922,21,42,2718027
2017,KNA,Saint Kitts and Nevis,0,0,0,0,0,0,0
2017,KOR,South Korea,3948,5130,193,171,279,21,9742
2017,KWT,Kuwait,0,0,0,0,0,129,129
2017,LAO,Laos,115118,176979,106835,2206,0,0,401138
2017,LBN,Lebanon,64,0,64,0,0,0,128
2017,LBR,Liberia,26230,12966,107,729,343,0,40375
2017,LBY,Libya,0,21,0,0,0,0,21
2017,LCA,Saint Lucia,0,0,0,0,0,0,0
2017,LIE,Liechtenstein,0,0,0,0,0,0,0
2017,LKA,Sri Lanka,1997,0,21,0,0,0,2018
2017,LSO,Lesotho,686,772,18374,0,0,0,19832
2017,LTU,Lithuania,64,0,0,0,0,0,64
2017,LUX,Luxembourg,0,0,0,0,0,0,0
2017,LVA,Latvia,0,21,0,21,0,0,42
2017,MAC,Macao,0,0,0,0,0,0,0
2017,MAR,Morocco,493,1309,1350,43,0,0,3195
2017,MDA,Moldova,32085,342,128,85,21,0,32661
2017,MDG,Madagascar,119415,1180686,1917242,25500,278,5880,3249001
2017,MEX,Mexico,421662,1040788,437528,17424,938,6480,1924820
2017,MKD,Macedonia,5019,7382,6264,0,21,64,18750
2017,MLI,Mali,2562098,555491,2651957,18996,21,750,5789313
2017,MLT,Malta,0,0,0,0,0,0,0
2017,MMR,Myanmar,906226,1707457,190056,9115,21,0,2812875
2017,MNE,Montenegro,6565,23201,729,966,21,149,31631
2017,MNG,Mongolia,97563,62227,343409,235,0,1330,504764
2017,MNP,Northern Mariana Islands,0,0,0,0,0,0,0
2017,MOZ,Mozambique,1238108,11514998,4557917,438891,256,114605,17864775
2017,MRT,Mauritania,56519,0,24769,2102,0,85,83475
2017,MSR,Montserrat,0,0,0,0,0,0,0
2017,MTQ,Martinique,0,0,0,0,0,0,0
2017,MUS,Mauritius,0,0,0,0,0,0,0
2017,MWI,Malawi,95176,206259,84799,29962,192,515,416903
2017,MYS,Malaysia,344,193,0,43,0,0,580
2017,MYT,Mayotte,0,0,0,0,0,0,0
2017,NAM,Namibia,164749,623062,1905373,25285,254,1007,2719730
2017,NCL,New Caledonia,1718,1996,1567,21,0,0,5302
2017,NER,Niger,80452,301,183575,17235,0,2811,284374
2017,NGA,Nigeria,4235343,1719175,1304518,145377,1818,318,7406549
2017,NIC,Nicaragua,37971,28832,19939,4182,472,0,91396
2017,NLD,Netherlands,0,0,0,0,0,0,0
2017,NOR,Norway,0,0,0,21,0,0,21
2017,NPL,Nepal,28076,104408,1824,64,0,0,134372
2017,NRU,Nauru,0,0,0,0,0,0,0
2017,NZL,New Zealand,215,751,2554,0,0,85,3605
2017,OMN,Oman,0,0,0,0,0,880,880
2017,PAK,Pakistan,258514,2359,5922,3542,128,621,271086
2017,PAN,Panama,15840,984,943,150,21,150,18088
2017,PER,Peru,11413,21352,29599,748,63,5042,68217
2017,PHL,Philippines,52953,4248,8236,407,43,0,65887
2017,PLW,Palau,0,0,0,0,0,0,0
2017,PNG,Papua New Guinea,132403,10533,17406,2999,557,0,163898
2017,POL,Poland,343,558,43,0,21,0,965
2017,PRI,Puerto Rico,0,21,279,0,0,0,300
2017,PRK,North Korea,6630,12040,1050,407,0,150,20277
2017,PRT,Portugal,90949,417872,7985,4718,1607,491,523622
2017,PRY,Paraguay,682822,1556958,822993,514381,318,42,3577514
2017,PSE,Palestina,193,0,258,0,0,21,472
2017,PYF,French Polynesia,0,0,0,0,0,0,0
2017,QAT,Qatar,0,0,43,0,64,128,235
2017,REU,Reunion,0,0,0,0,0,0,0
2017,ROU,Romania,109834,3775,3880,15904,342,0,133735
2017,RUS,Russia,2469093,4125247,1396959,132665,9410,17016,8150390
2017,RWA,Rwanda,8758,6461,33209,4378,0,0,52806
2017,SAU,Saudi Arabia,2512,0,21,21,0,3412,5966
2017,SDN,Sudan,1344296,1170080,3883987,70298,643,2895,6472199
2017,SEN,Senegal,449514,1569367,2229184,8752,21,86,4256924
2017,SGP,Singapore,0,0,0,0,0,0,0
2017,SHN,Saint Helena,0,0,0,0,0,0,0
2017,SJM,Svalbard and Jan Mayen,0,0,0,0,0,0,0
2017,SLB,Solomon Islands,0,0,0,0,0,0,0
2017,SLE,Sierra Leone,447821,401564,43960,7703,642,0,901690
2017,SLV,El Salvador,8497,16052,0,42,0,0,24591
2017,SMR,San Marino,0,0,0,0,0,0,0
2017,SOM,Somalia,43,0,0,0,64,0,107
2017,SPM,Saint Pierre and Miquelon,0,0,0,0,0,0,0
2017,SRB,Serbia,23841,1459,2853,21,0,21,28195
2017,SSD,South Sudan,520609,13582974,11448996,1068204,299,278,26621360
2017,STP,São Tomé and Príncipe,0,0,0,0,0,0,0
2017,SUR,Suriname,450,2296,20693,85,0,0,23524
2017,SVK,Slovakia,256,86,0,0,386,0,728
2017,SVN,Slovenia,64,0,64,0,0,0,128
2017,SWE,Sweden,172,0,0,0,0,0,172
2017,SWZ,Swaziland,14766,11204,17645,170,21,901,44707
2017,SYC,Seychelles,0,0,0,0,0,0,0
2017,SYR,Syria,18032,943,363,0,21,6610,25969
2017,TCA,Turks and Caicos Islands,0,0,0,0,0,0,0
2017,TCD,Chad,1483828,1166455,4577062,144442,470,11526,7383783
2017,TGO,Togo,280988,453079,191519,558,191,0,926335
2017,THA,Thailand,690151,567010,37933,4473,552,0,1300119
2017,TJK,Tajikistan,623,0,64,21,0,0,708
2017,TKL,Tokelau,0,0,0,0,0,0,0
2017,TKM,Turkmenistan,30394,0,29213,235,0,5985,65827
2017,TLS,Timor-Leste,6759,729,0,0,21,0,7509
2017,TON,Tonga,0,0,0,0,0,0,0
2017,TTO,Trinidad and Tobago,1137,256,0,0,0,0,1393
2017,TUN,Tunisia,1738,13995,665,0,0,707,17105
2017,TUR,Turkey,472303,11139,4568,1392,1026,1236,491664
2017,TUV,Tuvalu,0,0,0,0,0,0,0
2017,TWN,Taiwan,0,0,21,0,0,0,21
2017,TZA,Tanzania,444211,6707132,2041005,1023341,149,2230,10218068
2017,UGA,Uganda,505467,1135221,793262,19676,234,0,2453860
2017,UKR,Ukraine,2368735,25469,34657,8166,17055,128,2454210
2017,UMI,United States Minor Outlying Islands,0,0,0,0,0,0,0
2017,URY,Uruguay,8858,1433,3987,772,0,21,15071
2017,USA,United States,695179,1405275,1758214,59917,4651,11580,3934816
2017,UZB,Uzbekistan,31102,193,7533,709,21,707,40265
2017,VCT,Saint Vincent and the Grenadines,0,0,0,0,0,0,0
2017,VEN,Venezuela,152335,136876,1715567,254278,662,172,2259890
2017,VGB,British Virgin Islands,0,0,0,0,0,0,0
2017,VIR,"Virgin Islands, U.S.",0,0,0,0,0,0,0
2017,VNM,Vietnam,432420,146239,15207,6116,638,0,600620
2017,VUT,Vanuatu,301,2124,0,0,0,0,2425
2017,WLF,Wallis and Futuna,0,0,0,0,0,0,0
2017,WSM,Samoa,0,0,0,0,0,0,0
2017,XAD,Akrotiri and Dhekelia,0,0,0,0,0,0,0
2017,XKO,Kosovo,408,1221,1460,0,0,0,3089
2017,XNC,Northern Cyprus,0,0,0,0,0,0,0
2017,YEM,Yemen,0,0,0,493,0,171,664
2017,ZAF,South Africa,444988,272867,2368327,22316,3127,6887,3118512
2017,ZMB,Zambia,2528826,14725499,3945512,550012,1218,365,21751432
2017,ZWE,Zimbabwe,534624,771848,1232332,4309,404,557,2544074
2018,AFG,Afghanistan,1202,0,42,472,0,0,1716
2018,AGO,Angola,825962,18513882,12481409,78731,1538,835,31902357
2018,ALA,Åland,0,0,0,0,0,0,0
2018,ALB,Albania,1910,2167,42,85,0,0,4204
2018,AND,Andorra,0,0,0,0,0,0,0
2018,ARE,United Arab Emirates,0,0,43,0,0,364,407
2018,ARG,Argentina,726702,524894,1819161,279366,1067,3324,3354514
2018,ARM,Armenia,13134,2509,685,0,0,0,16328
2018,ASM,American Samoa,0,0,0,0,0,0,0
2018,ATF,French Southern Territories,0,0,0,0,0,0,0
2018,ATG,Antigua and Barbuda,0,0,0,0,0,0,0
2018,AUS,Australia,447283,4718305,47054490,226269,641,19231,52466219
2018,AUT,Austria,0,279,0,0,0,0,279
2018,AZE,Azerbaijan,117091,5643,13265,21,21,21,136062
2018,BDI,Burundi,2509,12750,13737,171,0,0,29167
2018,BEL,Belgium,0,0,0,0,0,0,0
2018,BEN,Benin,197226,316425,786701,492,106,0,1300950
2018,BES,"Bonaire, Sint Eustatius and Saba",0,0,0,0,0,0,0
2018,BFA,Burkina Faso,358199,180076,923805,2746,0,21,1464847
2018,BGD,Bangladesh,2124,12686,12965,129,0,0,27904
2018,BGR,Bulgaria,44109,1178,171,85,21,0,45564
2018,BHR,Bahrain,0,0,0,0,0,0,0
2018,BHS,Bahamas,193,3564,64,106,21,0,3948
2018,BIH,Bosnia and Herzegovina,408,149,771,107,0,0,1435
2018,BLR,Belarus,31768,15752,1522,1202,450,0,50694
2018,BLZ,Belize,3498,11590,5021,729,0,0,20838
2018,BMU,Bermuda,0,0,0,0,0,0,0
2018,BOL,Bolivia,284399,783182,558775,225476,170,171,1852173
2018,BRA,Brazil,2584871,1961240,3825728,344499,6532,1779,8724649
2018,BRB,Barbados,0,0,0,0,0,0,0
2018,BRN,Brunei,0,0,0,0,0,0,0
2018,BTN,Bhutan,578,2233,107,0,0,0,2918
2018,BWA,Botswana,121497,201198,2313697,132379,0,1180,2769951
2018,CAF,Central African Republic,356654,14976843,2700401,10490,769,42,18045199
2018,CAN,Canada,47266,1611358,82295,65382,0,9764,1816065
2018,CHE,Switzerland,0,0,0,0,0,0,0
2018,CHL,Chile,14982,10945,10899,0,235,213,37274
2018,CHN,China,1103466,332075,124879,30625,25513,3474,1620032
2018,CIV,Côte d'Ivoire,152298,1217537,152683,1994,448,0,1524960
2018,CMR,Cameroon,226334,1556059,343045,45033,193,42,2170706
2018,COD,Democratic Republic of the Congo,2562437,24943696,3134068,1388675,8082,1179,32038137
2018,COG,Republic of Congo,476796,2204461,1074667,21934,170,0,3778028
2018,COL,Colombia,101271,536166,1666416,208063,362,64,2512342
2018,COM,Comoros,149,235,21,0,0,0,405
2018,CPV,Cape Verde,0,0,0,0,0,0,0
2018,CRI,Costa Rica,24083,16914,1268,363,42,0,42670
2018,CUB,Cuba,47868,15240,10961,3362,84,0,77515
2018,CYM,Cayman Islands,0,0,0,0,0,0,0
2018,CYP,Cyprus,0,0,0,0,0,0,0
2018,CZE,Czech Republic,641,42,21,0,0,0,704
2018,DEU,Germany,4058,85,127,944,0,0,5214
2018,DJI,Djibouti,0,0,0,0,0,0,0
2018,DMA,Dominica,0,0,0,0,0,0,0
2018,DNK,Denmark,342,86,86,42,0,0,556
2018,DOM,Dominican Republic,9613,706,449,599,0,0,11367
2018,DZA,Algeria,4313,1138,385,0,0,0,5836
2018,ECU,Ecuador,7554,8775,5986,2940,0,86,25341
2018,EGY,Egypt,428,0,0,0,0,4872,5300
2018,ERI,Eritrea,5773,0,1417,43,21,193,7447
2018,ESH,Western Sahara,0,0,0,0,0,0,0
2018,ESP,Spain,4208,5666,2746,107,64,64,12855
2018,EST,Estonia,192,148,43,0,21,0,404
2018,ETH,Ethiopia,339825,2829353,1928363,26894,43,20542,5145020
2018,FIN,Finland,258,2425,816,299,1782,64,5644
2018,FJI,Fiji,1610,643,0,86,0,0,2339
2018,FRA,France,643,621,129,0,0,0,1393
2018,FRO,Faroe Islands,0,0,0,0,0,0,0
2018,FSM,Micronesia,0,0,0,0,0,0,0
2018,GAB,Gabon,6245,121774,173980,106,0,0,302105
2018,GBR,United Kingdom,644,278,3605,2490,0,0,7017
2018,GEO,Georgia,13351,277,300,0,0,300,14228
2018,GGY,Guernsey,0,0,0,0,0,0,0
2018,GHA,Ghana,967509,2908835,1049548,11377,383,150,4937802
2018,GIN,Guinea,448271,2129605,367322,16976,150,0,2962324
2018,GLP,Guadeloupe,0,0,0,0,0,0,0
2018,GMB,Gambia,124138,37266,13888,4529,21,278,180120
2018,GNB,Guinea-Bissau,24641,368393,9013,10063,21,0,412131
2018,GNQ,Equatorial Guinea,0,64,0,0,0,0,64
2018,GRC,Greece,19168,4937,2876,0,472,429,27882
2018,GRD,Grenada,0,0,0,0,0,0,0
2018,GRL,Greenland,0,0,0,0,0,0,0
2018,GTM,Guatemala,129631,46426,5107,1178,106,0,182448
2018,GUF,French Guiana,86,816,644,149,0,0,1695
2018,GUM,Guam,0,0,0,0,0,0,0
2018,GUY,Guyana,20152,24728,25650,2918,214,0,73662
2018,HKG,Hong Kong,215,0,236,0,21,0,472
2018,HND,Honduras,62267,185524,86205,2187,190,0,336373
2018,HRV,Croatia,279,214,493,21,0,0,1007
2018,HTI,Haiti,21,793,1738,106,0,0,2658
2018,HUN,Hungary,1181,0,21,0,42,0,1244
2018,IDN,Indonesia,376443,158391,177453,7715,1520,0,721522
2018,IMN,Isle of Man,0,0,0,0,0,0,0
2018,IND,India,3902462,1570115,93776,9716,22446,493,5599008
2018,IRL,Ireland,128,212,364,857,0,0,1561
2018,IRN,Iran,96441,1588,9823,3005,1647,52653,165157
2018,IRQ,Iraq,89612,7254,24293,6715,64,31502,159440
2018,ISL,Iceland,0,0,0,0,0,0,0
2018,ISR,Israel,0,0,86,21,0,21,128
2018,ITA,Italy,14143,2125,1351,21,128,42,17810
2018,JAM,Jamaica,1222,21,85,0,21,0,1349
2018,JEY,Jersey,0,0,0,0,0,0,0
2018,JOR,Jordan,0,0,0,21,0,64,85
2018,JPN,Japan,8713,6912,3156,148,429,0,19358
2018,KAZ,Kazakhstan,938591,21846,2502595,30048,1113,24617,3518810
2018,KEN,Kenya,55442,18585,56815,7597,0,6998,145437
2018,KGZ,Kyrgyzstan,3692,64,3005,107,0,1717,8585
2018,KHM,Cambodia,474409,2427569,50786,13303,43,0,2966110
2018,KNA,Saint Kitts and Nevis,0,0,0,0,0,0,0
2018,KOR,South Korea,21,21,0,0,0,0,42
2018,KWT,Kuwait,0,0,171,21,0,1482,1674
2018,LAO,Laos,82572,157962,85906,1668,0,0,328108
2018,LBN,Lebanon,0,0,0,0,0,0,0
2018,LBR,Liberia,7617,5513,21,43,21,0,13215
2018,LBY,Libya,0,0,0,0,0,0,0
2018,LCA,Saint Lucia,0,0,0,0,0,0,0
2018,LIE,Liechtenstein,0,0,0,0,0,0,0
2018,LKA,Sri Lanka,13008,0,535,515,0,0,14058
2018,LSO,Lesotho,235,600,6243,0,0,0,7078
2018,LTU,Lithuania,623,64,21,0,0,0,708
2018,LUX,Luxembourg,0,0,0,0,0,0,0
2018,LVA,Latvia,192,923,0,665,0,0,1780
2018,MAC,Macao,0,0,0,0,0,0,0
2018,MAR,Morocco,3326,129,193,0,43,21,3712
2018,MDA,Moldova,12363,643,192,21,343,0,13562
2018,MDG,Madagascar,107246,1084195,2073067,28121,534,5429,3298592
2018,MEX,Mexico,339809,690547,256757,14181,1130,5747,1308171
2018,MKD,Macedonia,2061,579,86,64,0,0,2790
2018,MLI,Mali,1945129,407961,2472929,10795,128,7212,4844154
2018,MLT,Malta,0,0,0,0,0,0,0
2018,MMR,Myanmar,835984,1382310,179895,12680,729,0,2411598
2018,MNE,Montenegro,1180,1716,43,64,0,0,3003
2018,MNG,Mongolia,3690,14210,15303,85,0,1438,34726
2018,MNP,Northern Mariana Islands,0,0,0,0,0,0,0
2018,MOZ,Mozambique,1403328,13174348,4809209,492445,471,105717,19985518
2018,MRT,Mauritania,5473,150,16056,815,0,129,22623
2018,MSR,Montserrat,0,0,0,0,0,0,0
2018,MTQ,Martinique,0,0,0,0,0,0,0
2018,MUS,Mauritius,86,0,0,0,0,0,86
2018,MWI,Malawi,178051,261746,90402,35905,106,322,566532
2018,MYS,Malaysia,13477,5170,86,256,129,0,19118
2018,MYT,Mayotte,0,0,0,0,0,0,0
2018,NAM,Namibia,93202,337959,1519355,39111,364,664,1990655
2018,NCL,New Caledonia,880,150,772,0,0,0,1802
2018,NER,Niger,69442,558,248746,21122,0,771,340639
2018,NGA,Nigeria,3521004,1172054,1023658,104383,1969,63,5823131
2018,NIC,Nicaragua,48898,97260,74566,8712,450,0,229886
2018,NLD,Netherlands,0,0,0,21,0,0,21
2018,NOR,Norway,43,385,300,42,21,64,855
2018,NPL,Nepal,18892,98162,3560,149,0,0,120763
2018,NRU,Nauru,0,0,0,0,0,0,0
2018,NZL,New Zealand,215,0,193,0,0,172,580
2018,OMN,Oman,0,0,0,0,0,0,0
2018,PAK,Pakistan,297731,10581,8152,5580,86,1437,323567
2018,PAN,Panama,12730,985,2038,171,21,42,15987
2018,PER,Peru,7830,36041,25688,447,63,5600,75669
2018,PHL,Philippines,71432,4309,12189,318,0,0,88248
2018,PLW,Palau,0,0,0,0,0,0,0
2018,PNG,Papua New Guinea,220817,98479,93158,1972,771,0,415197
2018,POL,Poland,3885,429,0,21,43,0,4378
2018,PRI,Puerto Rico,64,0,471,0,42,0,577
2018,PRK,North Korea,7513,19962,1073,63,0,43,28654
2018,PRT,Portugal,5579,29172,837,472,0,171,36231
2018,PRY,Paraguay,305714,628835,410079,331038,64,0,1675730
2018,PSE,Palestina,0,0,0,0,0,0,0
2018,PYF,French Polynesia,0,0,0,0,0,0,0
2018,QAT,Qatar,0,0,21,0,21,150,192
2018,REU,Reunion,0,0,0,0,0,0,0
2018,ROU,Romania,56619,1220,1735,728,685,0,60987
2018,RUS,Russia,2511618,7470395,1722932,335168,53072,31481,12124666
2018,RWA,Rwanda,3542,5558,23440,150,0,0,32690
2018,SAU,Saudi Arabia,1845,21,21,0,85,4014,5986
2018,SDN,Sudan,1155143,1088276,3686159,69886,340,5021,6004825
2018,SEN,Senegal,375033,1209408,1652480,5640,21,64,3242646
2018,SGP,Singapore,0,0,0,0,0,0,0
2018,SHN,Saint Helena,0,0,0,0,0,0,0
2018,SJM,Svalbard and Jan Mayen,0,0,0,0,0,0,0
2018,SLB,Solomon Islands,0,0,0,0,0,0,0
2018,SLE,Sierra Leone,310630,296378,44047,9056,363,0,660474
2018,SLV,El Salvador,7747,9697,42,43,43,0,17572
2018,SMR,San Marino,0,0,0,0,0,0,0
2018,SOM,Somalia,0,21,449,0,0,0,470
2018,SPM,Saint Pierre and Miquelon,0,0,0,0,0,0,0
2018,SRB,Serbia,47801,1221,5385,364,0,107,54878
2018,SSD,South Sudan,633348,14692378,18200587,1196439,877,106,34723735
2018,STP,São Tomé and Príncipe,0,0,0,0,0,0,0
2018,SUR,Suriname,1287,10346,4658,149,21,0,16461
2018,SVK,Slovakia,43,322,0,0,0,0,365
2018,SVN,Slovenia,0,192,0,0,0,0,192
2018,SWE,Sweden,193,12814,450,2254,0,0,15711
2018,SWZ,Swaziland,15411,11868,17622,21,85,300,45307
2018,SYC,Seychelles,0,0,0,0,0,0,0
2018,SYR,Syria,9334,171,256,0,21,3454,13236
2018,TCA,Turks and Caicos Islands,0,0,0,0,0,0,0
2018,TCD,Chad,1824017,1208740,5281862,103222,86,97733,8515660
2018,TGO,Togo,264693,323253,86422,321,43,0,674732
2018,THA,Thailand,601612,265865,29975,5869,170,0,903491
2018,TJK,Tajikistan,193,0,0,43,0,0,236
2018,TKL,Tokelau,0,0,0,0,0,0,0
2018,TKM,Turkmenistan,29709,21,2208,343,0,2360,34641
2018,TLS,Timor-Leste,4226,514,0,0,0,0,4740
2018,TON,Tonga,0,0,0,0,0,0,0
2018,TTO,Trinidad and Tobago,343,0,0,0,21,0,364
2018,TUN,Tunisia,236,601,0,21,0,128,986
2018,TUR,Turkey,325757,3066,3446,943,962,1324,335498
2018,TUV,Tuvalu,0,0,0,0,0,0,0
2018,TWN,Taiwan,0,0,0,0,0,0,0
2018,TZA,Tanzania,494077,5542721,2480760,941509,127,2290,9461484
2018,UGA,Uganda,450089,829519,891767,6021,214,0,2177610
2018,UKR,Ukraine,1012882,68146,25120,8810,64948,21,1179927
2018,UMI,United States Minor Outlying Islands,0,0,0,0,0,0,0
2018,URY,Uruguay,6002,1134,5918,2852,43,0,15949
2018,USA,United States,637870,1401884,1624787,40878,4025,10465,3719909
2018,UZB,Uzbekistan,51343,473,17323,10324,0,599,80062
2018,VCT,Saint Vincent and the Grenadines,0,0,0,0,0,0,0
2018,VEN,Venezuela,395673,355189,2138450,336323,1305,107,3227047
2018,VGB,British Virgin Islands,0,0,0,0,0,0,0
2018,VIR,"Virgin Islands, U.S.",0,0,0,0,0,0,0
2018,VNM,Vietnam,608437,160013,20901,4309,919,0,794579
2018,VUT,Vanuatu,0,0,0,0,0,0,0
2018,WLF,Wallis and Futuna,0,0,0,0,0,0,0
2018,WSM,Samoa,0,0,0,0,0,0,0
2018,XAD,Akrotiri and Dhekelia,0,0,0,0,0,0,0
2018,XKO,Kosovo,663,602,85,0,21,0,1371
2018,XNC,Northern Cyprus,0,0,0,0,0,0,0
2018,YEM,Yemen,0,0,0,0,0,43,43
2018,ZAF,South Africa,386640,314604,2502083,12940,3815,6221,3226303
2018,ZMB,Zambia,2426734,14703733,4054724,545487,980,42,21731700
2018,ZWE,Zimbabwe,533964,845006,1265325,4848,363,598,2650104
2019,AFG,Afghanistan,773,0,4958,0,0,8457,14188
2019,AGO,Angola,898130,24409290,11895113,183441,1731,407,37388112
2019,ALA,Åland,0,0,0,0,0,0,0
2019,ALB,Albania,2360,1181,172,0,0,21,3734
2019,AND,Andorra,0,0,0,0,0,0,0
2019,ARE,United Arab Emirates,0,0,0,0,0,150,150
2019,ARG,Argentina,543765,456962,988173,256318,1565,1457,2248240
2019,ARM,Armenia,9873,3455,4378,43,0,0,17749
2019,ASM,American Samoa,0,0,0,0,0,0,0
2019,ATF,French Southern Territories,0,0,0,0,0,0,0
2019,ATG,Antigua and Barbuda,0,0,0,0,0,0,0
2019,AUS,Australia,693236,8607261,26791293,266281,1350,21226,36380647
2019,AUT,Austria,0,64,0,0,0,0,64
2019,AZE,Azerbaijan,204632,9120,48232,42,21,234,262281
2019,BDI,Burundi,3130,11139,15905,472,0,0,30646
2019,BEL,Belgium,0,0,0,0,0,0,0
2019,BEN,Benin,176039,410637,908690,85,21,0,1495472
2019,BES,"Bonaire, Sint Eustatius and Saba",0,0,0,0,0,0,0
2019,BFA,Burkina Faso,448677,170307,924532,406,21,0,1543943
2019,BGD,Bangladesh,1715,8135,12622,0,0,0,22472
2019,BGR,Bulgaria,161676,2895,2274,664,171,21,167701
2019,BHR,Bahrain,0,0,0,0,0,0,0
2019,BHS,Bahamas,278,7962,128,234,64,0,8666
2019,BIH,Bosnia and Herzegovina,1803,3327,6739,0,0,0,11869
2019,BLR,Belarus,22644,8304,3067,749,128,0,34892
2019,BLZ,Belize,12556,28204,7576,2230,0,0,50566
2019,BMU,Bermuda,0,0,0,0,0,0,0
2019,BOL,Bolivia,481629,2932774,1400324,670698,426,643,5486494
2019,BRA,Brazil,4000522,5119647,8954165,1455047,9113,2445,19540939
2019,BRB,Barbados,0,0,0,0,0,0,0
2019,BRN,Brunei,0,86,0,21,0,0,107
2019,BTN,Bhutan,664,2404,64,0,0,0,3132
2019,BWA,Botswana,30608,76201,882140,189308,0,343,1178600
2019,CAF,Central African Republic,345231,11880214,2476580,15772,813,212,14718822
2019,CAN,Canada,20200,1170707,52634,41770,21,2144,1287476
2019,CHE,Switzerland,0,0,0,0,0,0,0
2019,CHL,Chile,27922,47137,36958,686,86,812,113601
2019,CHN,China,2027704,210702,232378,102428,20491,2339,2596042
2019,CIV,Côte d'Ivoire,76178,924748,122116,469,492,0,1124003
2019,CMR,Cameroon,278005,1508793,315482,59650,577,21,2162528
2019,COD,Democratic Republic of the Congo,2764046,25409573,3303592,1666946,7369,341,33151867
2019,COG,Republic of Congo,366185,2083752,1210220,28652,127,0,3688936
2019,COL,Colombia,57776,149545,1190450,268318,277,0,1666366
2019,COM,Comoros,815,1374,215,0,0,0,2404
2019,CPV,Cape Verde,0,0,0,0,0,0,0
2019,CRI,Costa Rica,24449,20264,364,150,21,0,45248
2019,CUB,Cuba,54409,12489,9803,2037,21,0,78759
2019,CYM,Cayman Islands,0,0,0,0,0,0,0
2019,CYP,Cyprus,0,86,21,0,0,0,107
2019,CZE,Czech Republic,3970,107,42,0,21,0,4140
2019,DEU,Germany,5002,106,86,0,64,0,5258
2019,DJI,Djibouti,0,0,193,0,0,236,429
2019,DMA,Dominica,0,0,0,0,0,0,0
2019,DNK,Denmark,172,0,0,0,0,0,172
2019,DOM,Dominican Republic,4182,1972,621,1525,43,0,8343
2019,DZA,Algeria,25541,36792,7275,258,0,4400,74266
2019,ECU,Ecuador,19704,21788,12147,11804,0,107,65550
2019,EGY,Egypt,3241,0,64,43,0,11162,14510
2019,ERI,Eritrea,25565,428,12191,106,0,107,38397
2019,ESH,Western Sahara,0,0,0,0,0,0,0
2019,ESP,Spain,16847,26166,7340,86,43,666,51148
2019,EST,Estonia,107,0,0,193,0,0,300
2019,ETH,Ethiopia,325443,2682030,1367522,30863,63,2746,4408667
2019,FIN,Finland,2232,494,0,21,0,0,2747
2019,FJI,Fiji,129,86,0,86,0,0,301
2019,FRA,France,10817,13823,22367,64,86,21,47178
2019,FRO,Faroe Islands,0,0,0,0,0,0,0
2019,FSM,Micronesia,0,0,0,0,0,0,0
2019,GAB,Gabon,30672,173696,260788,708,0,0,465864
2019,GBR,United Kingdom,64,601,7707,7255,0,0,15627
2019,GEO,Georgia,38572,6482,558,43,43,21,45719
2019,GGY,Guernsey,0,0,0,0,0,0,0
2019,GHA,Ghana,1017135,2517792,1205523,8992,556,128,4750126
2019,GIN,Guinea,504788,2670270,400466,18287,491,42,3594344
2019,GLP,Guadeloupe,0,0,0,0,0,0,0
2019,GMB,Gambia,98786,31255,17021,5538,0,171,152771
2019,GNB,Guinea-Bissau,21183,332269,9977,12682,0,64,376175
2019,GNQ,Equatorial Guinea,0,0,0,21,0,0,21
2019,GRC,Greece,13157,3778,3048,85,21,85,20174
2019,GRD,Grenada,0,0,0,0,0,0,0
2019,GRL,Greenland,0,0,408,21,0,0,429
2019,GTM,Guatemala,158950,93330,15729,1134,275,171,269589
2019,GUF,French Guiana,0,171,64,86,64,0,385
2019,GUM,Guam,0,0,0,0,0,0,0
2019,GUY,Guyana,23930,43660,29728,4614,193,0,102125
2019,HKG,Hong Kong,0,0,0,0,0,0,0
2019,HND,Honduras,57482,184389,63495,1930,213,0,307509
2019,HRV,Croatia,1695,1114,1438,0,0,0,4247
2019,HTI,Haiti,0,43,1267,0,0,0,1310
2019,HUN,Hungary,2123,21,750,43,0,0,2937
2019,IDN,Indonesia,1148800,683311,236058,21926,1774,0,2091869
2019,IMN,Isle of Man,0,0,0,0,0,0,0
2019,IND,India,3841138,908389,69285,16758,23115,365,4859050
2019,IRL,Ireland,21,0,21,880,0,0,922
2019,IRN,Iran,221091,579,25167,5300,1175,83317,336629
2019,IRQ,Iraq,666744,493,12957,1668,811,870328,1553001
2019,ISL,Iceland,0,0,0,0,0,0,0
2019,ISR,Israel,1973,300,794,0,0,236,3303
2019,ITA,Italy,59499,1780,7897,127,21,84,69408
2019,JAM,Jamaica,3563,257,0,107,0,0,3927
2019,JEY,Jersey,0,0,0,0,0,0,0
2019,JOR,Jordan,64,0,0,43,0,365,472
2019,JPN,Japan,8135,4957,2576,150,321,0,16139
2019,KAZ,Kazakhstan,2291396,18581,5651530,140963,1372,204757,8308599
2019,KEN,Kenya,77398,64501,88006,11869,0,6223,247997
2019,KGZ,Kyrgyzstan,7814,43,2468,0,0,386,10711
2019,KHM,Cambodia,483817,1723792,59579,120779,43,0,2388010
2019,KNA,Saint Kitts and Nevis,0,0,0,0,0,0,0
2019,KOR,South Korea,665,2469,0,43,21,0,3198
2019,KWT,Kuwait,0,0,0,0,0,1266,1266
2019,LAO,Laos,111940,331745,228994,4567,0,0,677246
2019,LBN,Lebanon,107,0,1073,0,21,64,1265
2019,LBR,Liberia,94983,48838,149,879,0,0,144849
2019,LBY,Libya,2210,0,236,0,0,3047,5493
2019,LCA,Saint Lucia,0,0,0,0,0,0,0
2019,LIE,Liechtenstein,0,0,0,0,0,0,0
2019,LKA,Sri Lanka,6674,170,514,0,0,0,7358
2019,LSO,Lesotho,342,1544,25865,21,0,0,27772
2019,LTU,Lithuania,42,0,0,0,0,0,42
2019,LUX,Luxembourg,0,0,0,0,0,0,0
2019,LVA,Latvia,42,0,0,21,0,0,63
2019,MAC,Macao,0,0,0,0,0,0,0
2019,MAR,Morocco,1845,2682,515,43,0,0,5085
2019,MDA,Moldova,13565,1052,85,42,150,0,14894
2019,MDG,Madagascar,85584,1117427,2350575,25778,427,5150,3584941
2019,MEX,Mexico,466093,1080387,407668,16047,1368,4695,1976258
2019,MKD,Macedonia,5792,5062,3903,64,42,21,14884
2019,MLI,Mali,2168199,524562,2745207,8842,0,11718,5458528
2019,MLT,Malta,0,0,0,0,0,0,0
2019,MMR,Myanmar,737722,1652098,256795,10233,406,0,2657254
2019,MNE,Montenegro,257,2016,0,0,0,0,2273
2019,MNG,Mongolia,47953,21488,271092,279,0,794,341606
2019,MNP,Northern Mariana Islands,0,0,0,0,0,0,0
2019,MOZ,Mozambique,1268201,11698782,5066262,425369,234,107906,18566754
2019,MRT,Mauritania,13265,3133,138325,2275,0,943,157941
2019,MSR,Montserrat,0,0,0,0,0,0,0
2019,MTQ,Martinique,0,0,0,0,0,0,0
2019,MUS,Mauritius,0,0,0,0,0,0,0
2019,MWI,Malawi,113296,190524,94312,26957,107,235,425431
2019,MYS,Malaysia,19987,11114,772,1669,363,0,33905
2019,MYT,Mayotte,0,0,0,0,0,0,0
2019,NAM,Namibia,45592,189626,637277,47203,64,85,919847
2019,NCL,New Caledonia,5131,5344,4143,21,0,0,14639
2019,NER,Niger,80046,1265,160588,20649,0,23611,286159
2019,NGA,Nigeria,3564386,1653857,1050360,70492,2248,469,6341812
2019,NIC,Nicaragua,64610,102130,38892,4739,407,21,210799
2019,NLD,Netherlands,21,0,0,0,0,0,21
2019,NOR,Norway,0,451,794,21,0,0,1266
2019,NPL,Nepal,36277,279376,2770,107,0,0,318530
2019,NRU,Nauru,0,0,0,0,0,0,0
2019,NZL,New Zealand,643,1308,3197,0,21,235,5404
2019,OMN,Oman,0,0,0,0,0,966,966
2019,PAK,Pakistan,168785,1458,4957,1350,84,1393,178027
2019,PAN,Panama,42223,18953,4487,579,84,299,66625
2019,PER,Peru,17425,63921,50141,964,363,2487,135301
2019,PHL,Philippines,84864,11968,8580,835,321,0,106568
2019,PLW,Palau,0,0,0,0,0,0,0
2019,PNG,Papua New Guinea,118534,25236,27133,3603,623,0,175129
2019,POL,Poland,815,21,0,0,0,0,836
2019,PRI,Puerto Rico,64,150,987,0,0,0,1201
2019,PRK,North Korea,13393,28698,1651,428,193,85,44448
2019,PRT,Portugal,7616,20863,601,0,170,0,29250
2019,PRY,Paraguay,416028,1095744,651553,364549,170,193,2528237
2019,PSE,Palestina,386,0,192,0,0,0,578
2019,PYF,French Polynesia,0,0,0,0,0,0,0
2019,QAT,Qatar,0,0,0,0,43,64,107
2019,REU,Reunion,0,0,0,0,0,0,0
2019,ROU,Romania,159245,3578,2052,33398,319,0,198592
2019,RUS,Russia,2498720,6475674,2260312,359294,12893,59818,11666711
2019,RWA,Rwanda,3755,3498,28206,5988,0,0,41447
2019,SAU,Saudi Arabia,1052,0,106,0,0,3456,4614
2019,SDN,Sudan,956581,1020573,3437888,55916,599,21401,5492958
2019,SEN,Senegal,382266,1442634,2192950,14166,21,170,4032207
2019,SGP,Singapore,0,0,0,0,0,0,0
2019,SHN,Saint Helena,0,0,0,0,0,0,0
2019,SJM,Svalbard and Jan Mayen,0,0,0,0,0,0,0
2019,SLB,Solomon Islands,0,0,0,0,0,0,0
2019,SLE,Sierra Leone,263731,271607,41473,7190,428,0,584429
2019,SLV,El Salvador,5790,12278,64,43,86,0,18261
2019,SMR,San Marino,0,0,0,0,0,0,0
2019,SOM,Somalia,2126,258,299,0,21,43,2747
2019,SPM,Saint Pierre and Miquelon,0,0,0,0,0,0,0
2019,SRB,Serbia,26205,5686,1781,342,0,0,34014
2019,SSD,South Sudan,469242,8770379,7660477,1139193,341,0,18039632
2019,STP,São Tomé and Príncipe,0,0,0,21,0,0,21
2019,SUR,Suriname,2983,18118,24857,1093,43,0,47094
2019,SVK,Slovakia,300,0,0,0,150,0,450
2019,SVN,Slovenia,0,64,0,0,0,0,64
2019,SWE,Sweden,0,0,0,0,0,0,0
2019,SWZ,Swaziland,37286,34023,52528,643,214,1072,125766
2019,SYC,Seychelles,0,0,0,0,0,0,0
2019,SYR,Syria,542312,986,24082,236,1306,229918,798840
2019,TCA,Turks and Caicos Islands,0,0,0,0,0,0,0
2019,TCD,Chad,1486315,756109,4091930,117649,149,68711,6520863
2019,TGO,Togo,187311,322610,142189,301,150,0,652561
2019,THA,Thailand,979177,787263,111802,8223,383,0,1886848
2019,TJK,Tajikistan,128,0,0,0,0,0,128
2019,TKL,Tokelau,0,0,0,0,0,0,0
2019,TKM,Turkmenistan,81031,0,217898,85,0,65466,364480
2019,TLS,Timor-Leste,9723,2896,64,43,0,0,12726
2019,TON,Tonga,0,0,0,0,0,0,0
2019,TTO,Trinidad and Tobago,343,150,85,0,0,0,578
2019,TUN,Tunisia,3948,2188,279,0,0,407,6822
2019,TUR,Turkey,384403,10857,10469,1111,813,1861,409514
2019,TUV,Tuvalu,0,0,0,0,0,0,0
2019,TWN,Taiwan,730,0,0,21,0,0,751
2019,TZA,Tanzania,476491,6310938,2467302,1085178,278,4784,10344971
2019,UGA,Uganda,324318,429871,268254,14329,129,0,1036901
2019,UKR,Ukraine,1948046,80327,49144,12396,22400,21,2112334
2019,UMI,United States Minor Outlying Islands,0,0,0,0,0,0,0
2019,URY,Uruguay,12914,2723,6839,2508,42,64,25090
2019,USA,United States,824156,951298,988449,41548,2806,9525,2817782
2019,UZB,Uzbekistan,33550,42,23334,1653,21,2231,60831
2019,VCT,Saint Vincent and the Grenadines,0,0,0,0,0,0,0
2019,VEN,Venezuela,674297,446395,2146539,289589,1197,321,3558338
2019,VGB,British Virgin Islands,0,0,0,0,0,0,0
2019,VIR,"Virgin Islands, U.S.",0,0,0,0,0,0,0
2019,VNM,Vietnam,803389,140648,44013,9478,1045,64,998637
2019,VUT,Vanuatu,0,0,0,0,0,0,0
2019,WLF,Wallis and Futuna,0,0,0,0,0,0,0
2019,WSM,Samoa,0,0,0,0,0,0,0
2019,XAD,Akrotiri and Dhekelia,0,0,0,0,0,0,0
2019,XKO,Kosovo,1695,2940,1030,0,0,64,5729
2019,XNC,Northern Cyprus,0,0,0,0,0,0,0
2019,YEM,Yemen,0,0,0,150,0,85,235
2019,ZAF,South Africa,418140,258956,2182544,13776,3302,6951,2883669
2019,ZMB,Zambia,2494612,15384367,4218496,745100,1390,279,22844244
2019,ZWE,Zimbabwe,565516,951320,1066334,4959,255,1717,2590101
